ぶつこう	物攻	名詞	
ぶつぼう	物防	名詞	
じゅつこう	術攻	名詞	
じゅつぼう	術防	名詞	
まこう	魔攻	名詞	
まぼう	魔防	名詞	
おうぎ	奥義	名詞	
そうまおうぎ	蒼魔奥義	名詞	
そうまほうじゅ	蒼魔宝珠	名詞	
ひおうぎ	秘奥義	名詞	
しょうじゅつ	晶術	名詞	
しょうれいじゅつ	晶霊術	名詞	
どうじゅつ	導術	名詞	
れんじゅつ	錬術	名詞	
じんじゅつ	陣術	名詞	
そうじゅつ	爪術	名詞	
ふじゅつ	譜術	名詞	
てんじゅつ	天術	名詞	
こうたい	鋼体	名詞	
えいきゃん	詠キャン	名詞	
えいしょうきゃんせる	詠唱キャンセル	名詞	
とうき	闘気	名詞	
しょうき	瘴気	名詞	
いがぐり	伊賀栗	名詞	
まかがく	魔科学	名詞	
まどうほう	魔導砲	名詞	
かみのめ	神の眼	名詞	
がいかく	外殻	名詞	
がいかくだいち	外殻大地	名詞	
れんぶらんと	レンブラント	名詞	
れんぶらんと	煉武乱屠	名詞	
りゅうがんさんみゃく	竜岩山脈	名詞	
ふぃりあとくせい	フィリア特製フルーツパフェ・ウィズ・チョコレートバナ〜ヌおいしおいし	名詞	
ごらんしん	御乱神	名詞	
げきれつちょうてんさいすししょくにんさま	激烈超天才寿司職人様	名詞	
げきれつ	激烈超天才寿司職人様	名詞	
ごせいじん	五星刃	名詞	
まぐにすさま	マグニスさま	名詞	
ひえんのようえい	緋炎の揺曳	名詞	
てんしか	天使化	名詞	
しせい	四星	名詞	
ちんこんじょう	鎮魂錠	名詞	
そうが	滄我	名詞	
くうかつざん	空割山	名詞	
こうせきよく	光跡翼	名詞	
こうよんてん	紅四点	名詞	
せいそうじゅつ	聖爪術	名詞	
ここくご	古刻語	名詞	
てるくぇす	はじまりの翼	名詞	
めるねす	輝く人	名詞	
かがやくひと	輝く人	名詞	メルネス
めるふぇす	輝く海	名詞	
かがやくうみ	輝く海	名詞	メルフェス
ねるふぇす	滄我	名詞	
ふぉにむ	音素	名詞	
おんそ	音素	名詞	フォニム
ろくじんしょう	六神将	名詞	
せるぱーてぃくる	記憶粒子	名詞	
きおくりゅうし	記憶粒子	名詞	セルパーティクル
ふぉんぱわー	音素力	名詞	
おんそりょく	音素力	名詞	
ふぉんでぃすく	音譜盤	名詞	
おんふばん	音譜盤	名詞	フォンディスク
おんぷばん	音譜盤	名詞	フォンディスク
ふぉんべると	音譜帯	名詞	
おんふたい	音譜帯	名詞	フォンベルト
おんぷたい	音譜帯	名詞	フォンベルト
ふぁーすとふぉにむ	第一音素	名詞	
だいいちおんそ	第一音素	名詞	ファーストフォニム
せかんどふぉにむ	第二音素	名詞	
だいにおんそ	第二音素	名詞	セカンドフォニム
ふぉーすふぉにむ	第四音素	名詞	
だいよんおんそ	第四音素	名詞	フォースフォニム
しっくすふぉにむ	第六音素	名詞	
だいろくおんそ	第六音素	名詞	シックスフォニム
せぶんすふぉにむ	第七音素	名詞	
だいななおんそ	第七音素	名詞	セブンスフォニム
せぶんすふぉにまー	第七音譜術士	名詞	
だいななおんふじゅつし	第七音譜術士	名詞	セブンスフォニマー
だいななおんぷじゅつし	第七音譜術士	名詞	セブンスフォニマー
くりふぉと	魔界	名詞	
まかい	魔界	名詞	クリフォト
すこあらー	預言者	名詞	
よげんしゃ	預言者	名詞	スコアラー
すこあ	預言	名詞	
よげん	預言	名詞	スコア
らすとじゃっじめんとすこあ	消滅予言	名詞	
しょうめつよげん	消滅予言	名詞	ラストジャッジメントスコア
ぷらねっとすこあ	惑星預言	名詞	
わくせいよげん	惑星預言	名詞	プラネットスコア
わくせいすこあ	惑星預言	名詞	プラネットスコア
ふぉにっく・うぉー	譜術戦争	名詞	
ふぉにっくうぉー	譜術戦争	名詞	
ふじゅつせんそう	譜術戦争	名詞	フォニック・ウォー
あんちすぺる	譜術封印	名詞	
ふじゅつふういん	譜術封印	名詞	アンチスペル
そねっと	十四行詩	名詞	
じゅうよんぎょうし	十四行詩	名詞	ソネット
おらくる	神託の盾	名詞	
しんたくのたて	神託の盾	名詞	オラクル
ふごう	譜業	名詞	
ふか	譜歌	名詞	
ひーらー	治癒師	名詞	
ちゆし	治癒師	名詞	ヒーラー
のーむ	大地	名詞	
だあとしきふうじゅ	ダアト式封咒	名詞	
ふうじゅ	ダアト式封咒	名詞	
だあとしき	ダアト式封咒	名詞	
あんちふぉんすろっと	封印術	名詞	
ふういんじゅつ	封印術	名詞	アンチフォンスロット
う゛ぁんせんせい	ヴァン師匠	名詞	
ゔぁんせんせい	ヴァン師匠	名詞	
しんぜんたいし	親善大使	名詞	
そうせいりょく	創世力	名詞	
むけい	無恵	名詞	
しどうくん	士道訓	名詞	
しどうくんごかじょう	士道訓五箇条	名詞	
しどうくんごかじょう	心に剣を持ち　誰かの楯となれ	名詞	
しどうくんごかじょう	右手に規律を　左手に誇りを	名詞	
しどうくんごかじょう	己を殺し　永久の礎にせよ	名詞	
しどうくんごかじょう	正しき道を　正しく歩め	名詞	
しどうくんごかじょう	個よりも　全に仕えよ	名詞	
まんかんぜんせき	まンカんぜんセき	名詞	
つうしょうおいしおいし	通称おいしおいし	名詞	
いぶら・ひもびっち	イブラ・ヒモビッチ	名詞	
いぶらひもびっち	イブラ・ヒモビッチ	名詞	
じゅけつ	授血	名詞	
そてき	粗敵	名詞	
くちのききかたしらなたろう	口の利き方知らな太郎	名詞	
つうしょうおいしおいし	フルーツパフェ・ウィズ・ショコラバナ〜ヌおいしおいし	名詞	
わざしのぎほう	業師の技法	名詞	
りりのあかぼし	凛々の明星	名詞	
ぶらすてぃあ	魔導器	名詞	
まどうき	魔導器	名詞	ブラスティア
しるとぶらすてぃあ	結界魔導器	名詞	
けっかいまどうき	結界魔導器	名詞	シルトブラスティア
ぼーでぃぶらすてぃあ	武醒魔導器	名詞	
ぶせいまどうき	武醒魔導器	名詞	ボーディブラスティア
あくえぶらすてぃあ	水道魔導器	名詞	
すいどうまどうき	水道魔導器	名詞	アクエブラスティア
るくすぶらすてぃあ	光照魔導器	名詞	
こうしょうまどうき	光照魔導器	名詞	ルクスブラスティア
きねすぶらすてぃあ	転送魔導器	名詞	
てんそうまどうき	転送魔導器	名詞	キネスブラスティア
せろすぶらすてぃあ	駆動魔導器	名詞	
くどうまどうき	駆動魔導器	名詞	セロスブラスティア
ほぶろーぶらすてぃあ	兵装魔導器	名詞	
へいそうまどうき	兵装魔導器	名詞	ホブローブラスティア
くりあしえる	澄明の刻晶	名詞	
ちょうめいのこくしょう	澄明の刻晶	名詞	クリアシエル
あぱてぃあ	聖核	名詞	
せいかく	聖核	名詞	アパティア
あぱてぃあ・きゅあのしえる	聖核・蒼穹の水玉	名詞	
あぱてぃあきゅあのしえる	聖核・蒼穹の水玉	名詞	
きゅあのしえる	蒼穹の水玉	名詞	
そうきゅうのみずたま	蒼穹の水玉	名詞	キュアノシエル
まりす・すてら	麗しの星	名詞	
まりすすてら	麗しの星	名詞	
うるわしのほし	麗しの星	名詞	
まりす・げんま	馨しの珊瑚	名詞	
まりすげんま	馨しの珊瑚	名詞	
かぐわしのさんご	馨しの珊瑚	名詞	
さかびと	賢人	名詞	
けんじん	賢人	名詞	サカビト
そうりゅうれんがしゅう	爪竜連牙蹴	名詞	
でいんのもす	宙の戒典	名詞	
みょうじょういちごう	明星壱号	名詞	
みょうじょうにごう	明星弐号	名詞	
ちゅうのかいてん	宙の戒典	名詞	デインノモス
えんてれけいあ	始祖の隷長	名詞	
しそのれいちょう	始祖の隷長	名詞	エンテレケイア
ゆうきりんりんむねいっぱいだん	勇気凛々胸いっぱい団	名詞	
あるとすく	天を射る矢	名詞	
てんをいるや	天を射る矢	名詞	
ぶらっどあらいあんす	紅の絆傭兵団	名詞	
くれないのきずなようへいだん	紅の絆傭兵団	名詞	
りう゛ぁいあさんのつめ	海凶の爪	名詞	
りゔぁいあさんのつめ	海凶の爪	名詞	
かいきょうのつめ	海凶の爪	名詞	リヴァイアサンの爪
せいれーんのきば	海精の牙	名詞	
かいせいのきば	海精の牙	名詞	セイレーンの牙
さーぺんとのゆめ	海竜の夢	名詞	
かいりゅうのゆめ	海竜の夢	名詞	サーペントの夢
るーいんずげーと	遺構の門	名詞	
いこうのもん	遺構の門	名詞	ルーインズゲート
ぎるど・ど・まるしぇ	幸福の市場	名詞	
ぎるどどまるしぇ	幸福の市場	名詞	
こうふくのしじょう	幸福の市場	名詞	ギルド・ド・マルシェ
ぱれすとらーれ	戦士の殿堂	名詞	
せんしのでんどう	戦士の殿堂	名詞	パレストラーレ
どぅーちぇ	統領	名詞	
とうりょう	統領	名詞	ドゥーチェ
てんちのあなぐら	天地の窖	名詞	
ぱーぺちゅある	四季折々	名詞	
しきおりおり	四季折々	名詞	パーペチュアル
すみす・ざ・そうる	魂の鉄槌	名詞	
すみすざそうる	魂の鉄槌	名詞	
たましいのてっつい	魂の鉄槌	名詞	スミス・ザ・ソウル
ぎるどこーど	職盟暗号	名詞	
しょくめいあんごう	職盟暗号	名詞	ギルドコード
ほしはみ	星喰み	名詞	
ごーれむ	人間魔導器	名詞	
にんげんまどうき	人間魔導器	名詞	ゴーレム
ごーれむ	ゴーレム	名詞	
すきる	武能	名詞	
ぶのう	武能	名詞	スキル
すきる	スキル	名詞	
ざうでふらくきゅう	ザウデ不落宮	名詞	
よしづみ	吉積	名詞	
よしづみまこと	吉積信	名詞	
みやじま	実弥島	名詞	
みやじまたくみ	実弥島巧	名詞	
ふじしまこうすけ	藤島康介	名詞	
さくらばもとい	桜庭統	名詞	
なにきにすることはない	なに、気にすることはない	名詞	
なに、きにすることはない	なに、気にすることはない	名詞	
しねんじゅつ	思念術	名詞	
ちねん	地念	名詞	
すいねん	水念	名詞	
おんねん	怨念	名詞	
ふうねん	風念	名詞	
らんねん	嵐念	名詞	
えんねん	炎念	名詞	
あんねん	闇念	名詞	
こうねん	光念	名詞	
かいねん	海念	名詞	
きょねん	虚念	名詞	
くぉーと	結晶人	名詞	
くぉーてぃあ	結晶界	名詞	
せるれいど	原界人	名詞	
せるらんど	原界	名詞	
しゅごきし	守護機士	名詞	
むげんめっさつおにごっこ	無限滅殺オニごっこ	名詞	
げき・えんねつじごくゆきがっせん	激・炎熱地獄雪合戦	名詞	
げきえんねつじごくゆきがっせん	激・炎熱地獄雪合戦	名詞	
たーれん	大人	名詞	
ぜつぎ	絶技	名詞	
ごうぎ	合技	名詞	
えんぎ	援技	名詞	
たいとう	帯刀	名詞	
たいとうぎ	帯刀技	名詞	
たいとうわざ	帯刀技	名詞	
ばっとう	抜刀	名詞	
ばっとうじゅつ	抜刀技	名詞	
のうとう	納刀	名詞	
かくとうぎ	格闘技	名詞	
かくとうわざ	格闘技	名詞	
さいせいじゅつ	再生術	名詞	
こうし	光子	名詞	
こうしじゅつ	光子術	名詞	
そうけん	双剣	名詞	
りょうけん	両剣	名詞	
りょうけんぎ	両剣技	名詞	
りょうけんわざ	両剣技	名詞	
そうじゅうじゅつ	双銃術	名詞	
とうけんぎ	投剣技	名詞	
とうけんわざ	投剣技	名詞	
しんせいじゅつ	神聖術	名詞	
とうじん	投刃	名詞	
そうじんぎ	操刃技	名詞	
そうじんわざ	操刃技	名詞	
こうげきじゅつ	攻撃術	名詞	
ちょうきゅうこうげきじゅつ	超級攻撃術	名詞	
じゅうぎ	銃技	名詞	
ちょうじゅうぎ	長銃技	名詞	
ちょうじゅうわざ	長銃技	名詞	
ほうじんじゅつ	法陣術	名詞	
こほうじん	弧法陣	名詞	
さいけんぎ	細剣技	名詞	
さいけんわざ	細剣技	名詞	
いあつじゅつ	威圧術	名詞	
えれす	原素	名詞	
えれすはい	原素ハイ	名詞	
らくこんしゅ	落魂珠	名詞	
らくこんじゅ	落魂珠	名詞	
ぼうせい	暴星	名詞	
ぼうせいばりあ	暴星バリア	名詞	
じゅさつ	呪殺	名詞	
とうぎとう	闘技島	名詞	
ふぉすりとす	羅針帯	名詞	
らしんたい	羅針帯	名詞	フォスリトス
らすたりあ	星の核	名詞	
ほしのかく	星の核	名詞	ラスタリア
ぐろーあんでぃ	大翠緑石	名詞	
だいすいりょくせき	大翠緑石	名詞	グローアンディ
でゅーぷるまる	大蒼海石	名詞	
だいそうかいせき	大蒼海石	名詞	デュープルマル
ふぉるぶらんにる	大紅蓮石	名詞	
だいぐれんせき	大紅蓮石	名詞	フォルブランニル
かめしゃ	亀車	名詞	
ぷろとすへいす	プロトス1	名詞	
ぷろとす1	プロトス1	名詞	
ぷろとすいち	プロトス1	名詞	プロトスヘイス
たんりゅうしほぜん	単粒子保全	名詞	
ぶんげんほぜん	分減保全	名詞	
てるまでぃけいど	十芒星戦士	名詞	
じゅうぼうせいせんし	十芒星戦士	名詞	テルマディケイド
じゅうもうせいせんし	十芒星戦士	名詞	テルマディケイド
じゃいあんときどう	ジャイアント起動	名詞	
しぇりゆきひめ	シェリ雪姫	名詞	
しょうかんじゅつ	召喚術	名詞	
ほうじゅつ	法術	名詞	
そうけんわざ	双剣技	名詞	
とうてきじゅつ	投擲術	名詞	
けんげき	剣撃	名詞	
ざんとう	斬刀	名詞	
ごうぶ	轟斧	名詞	
ごうふ	轟斧	名詞	
そうじゅつ	槍術	名詞	
きゅうじゅつ	弓術	名詞	
てっぽう	鉄砲	名詞	
とうじゅつ	盗術	名詞	
にんじゅつ	忍術	名詞	
じゅうそう	獣操	名詞	
せいれい	精霊	名詞	
きし	騎士	名詞	
ようけん	妖剣	名詞	
けんとう	拳闘	名詞	
しゅうげき	蹴撃	名詞	
しじん	詩人	名詞	
まじゅつ	魔術	名詞	
けんじゅつ	賢術	名詞	
せんそう	旋槍	名詞	
じゅうぶ	獣斧	名詞	
じゅうふ	獣斧	名詞	
なりきりし	なりきり士	名詞	
はくぎんけんし	白銀剣士	名詞	
おうごんけんし	黄金剣士	名詞	
けんごう	剣豪	名詞	
けんてい	剣帝	名詞	
とうきゅうし	闘弓士	名詞	
おのせんし	斧戦士	名詞	
じゅうせんし	重戦士	名詞	
はかいせんし	破壊戦士	名詞	
しのび	忍	名詞	
おんみつ	隠密	名詞	
しのびがしら	忍頭	名詞	
にんじゃがしら	にんじゃがしら	名詞	
まものつかい	魔物使い	名詞	
ちょうきょうし	調教士	名詞	
まそうし	魔操士	名詞	
こうきし	甲騎士	名詞	
せいきし	聖騎士	名詞	
せんき	戦姫	名詞	
かくとうか	格闘家	名詞	
けんとうし	拳闘士	名詞	
けんせい	拳聖	名詞	
うたひめ	歌姫	名詞	
はるか	春香	名詞	
あすか	飛鳥	名詞	
だいまじゅつし	大魔術師	名詞	
ぷりずむりんぐ	虹輪	名詞	
こうりん	虹輪	名詞	プリズムリング
にじわ	虹輪	名詞	プリズムリング
ほむらおうのくさび	焔王の楔	名詞	
ひょうろうおうのいしずえ	氷狼王の礎	名詞	
ろきまかがくけんきゅうくつ	ロキ魔科学研究窟	名詞	
まかがくけんきゅうくつ	魔科学研究窟	名詞	
なむことう	ナム孤島	名詞	
しんりのしょうこく	審理の晶谷	名詞	
ついおくのゆがみ	追憶の歪み	名詞	
ほすちあ	星晶	名詞	
ほししょう	星晶	名詞	ホスチア
せいしょう	星晶	名詞	ホスチア
こうきたんじゅつ	光気丹術	名詞	
ついおくのこうどう	追憶の坑道	名詞	
きょうめいじゅつぎ	共鳴術技	名詞	リンクアーツ
しゅうちゅうかいひ	集中回避	名詞	
まぎ	魔技	名詞	
ぶしんわざ	武身技	名詞	
ぶしんぎ	武身技	名詞	
せいれいじゅつ	精霊術	名詞	
りんくあーつ	共鳴術技	名詞	
かっしんこんじゅつ	活伸棍術	名詞	
こんじゅつ	棍術	名詞	
じゅうれいじゅつ	獣隷術	名詞	
まそうじゅう	魔装獣	名詞	
りーぜまくしあ	リーゼ・マクシア	名詞	
りーぜ・まくしあ	リーゼ・マクシア	名詞	
らしゅがる	ラ・シュガル	名詞	
ら・しゅがる	ラ・シュガル	名詞	
あじゅーる	ア・ジュール	名詞	
あ・じゅーる	ア・ジュール	名詞	
いるふぁん	イル・ファン	名詞	
いる・ふぁん	イル・ファン	名詞	
おうといるふぁん	王都イル・ファン	名詞	
おうといる・ふぁん	王都イル・ファン	名詞	
るろんど	ル・ロンド	名詞	
る・ろんど	ル・ロンド	名詞	
からは・しゃーる	カラハ・シャール	名詞	
からはしゃーる	カラハ・シャール	名詞	
は・みる	ハ・ミル	名詞	
はみる	ハ・ミル	名詞	
に・あけりあ	ニ・アケリア	名詞	
にあけりあ	ニ・アケリア	名詞	
しゃん・どぅ	シャン・ドゥ	名詞	
しゃんどぅ	シャン・ドゥ	名詞	
かん・ばるく	カン・バルク	名詞	
かんばるく	カン・バルク	名詞	
かいてい	海停	名詞	
かいばく	海瀑	名詞	
きじるかいばく	キジル海瀑	名詞	
しょうや	沼野	名詞	
ふぁいざばーどしょうや	ファイザバード沼野	名詞	
じゅかい	樹界	名詞	
さまんがんじゅかい	サマンガン樹界	名詞	
さまんがん	東方辺境	名詞	
とうほうへんきょう	東方辺境	名詞	サマンガン
みこ	巫子	名詞	
まくすうぇるのみこ	マクスウェルの巫子	名詞	
みつばのくろーばー	光葉のクローバー	名詞	
げーと	霊力野	名詞	
れいりょくの	霊力野	名詞	ゲート
れいせい	霊勢	名詞	
よるいき	夜域	名詞	
じゅたい	呪帯	名詞	
じゅかん	呪環	名詞	
りくけ	六家	名詞	
よしょうせき	世精石	名詞	
ゔぁる	水旬	名詞	
う゛ぁる	水旬	名詞	
みずしゅん	水旬	名詞	ヴァル
すいしゅん	水旬	名詞	ヴァル
るーじ	火旬	名詞	
ひしゅん	火旬	名詞	
かしゅん	火旬	名詞	
じょぬ	地旬	名詞	
ちしゅん	地旬	名詞	ジョヌ
ぶらう	風旬	名詞	
かぜしゅん	風旬	名詞	ブラウ
ふうしゅん	風旬	名詞	ブラウ
べんと	風霊小節	名詞	1月
ふうれいしょうせつ	風霊小節	名詞	ベント
おらーじゅ	風霊盛節	名詞	2月
ふうれいじょうせつ	風霊盛節	名詞	オラージュ
かるむ	風霊終節	名詞	3月
ふうれいしゅうせつ	風霊終節	名詞	カルム
ぷりゅい	水霊小節	名詞	4月
すいれいしょうせつ	水霊小節	名詞	プリュイ
りゔぃえ	水霊盛節	名詞	5月
りう゛ぃえ	水霊盛節	名詞	5月
りびえ	水霊盛節	名詞	5月
すいれいせいせつ	水霊盛節	名詞	プリュイ
まーる	水霊終節	名詞	6月
すいれいしゅうせつ	水霊終節	名詞	プリュイ
ふー	火霊小節	名詞	7月
かれいしょうせつ	火霊小節	名詞	フー
ふらむ	火霊盛節	名詞	8月
かれいせいせつ	火霊盛節	名詞	フラム
さんどら	火霊終節	名詞	9月
かれいしゅうせつ	火霊終節	名詞	フラム
ぷらん	地霊小節	名詞	10月
ちれいしょうせつ	地霊小節	名詞	プラン
ぷらん	プラン	名詞	
あるぶ	地霊盛節	名詞	11月
ちれいせいせつ	地霊盛節	名詞	アルブ
ふぉれ	地霊終節	名詞	12月
ちれいしゅうせつ	地霊終節	名詞	フォレ
らのーむ	地場	名詞	
ちば	地場	名詞	ラノーム
いふりた	火場	名詞	
ひば	火場	名詞	イフリタ
らしるふ	風場	名詞	
かぜば	風場	名詞	ラシルフ
うんでぃす	水場	名詞	
みずば	水場	名詞	ウンディス
かくりよ	幽世	名詞	
はおのたまごりろん	ハオの卵理論	名詞	
しげんせいらいかん	四元精来還	名詞	
ぐらんろすと	大消失	名詞	
だいしょうしつ	大消失	名詞	グランロスト
しだい	四大	名詞	
じん	黒匣	名詞	
くろはこ	黒匣	名詞	ジン
こくこう	黒匣	名詞	ジン
おりじん	源霊匣	名詞	
げんれいこう	源霊匣	名詞	オリジン
げんれいはこ	源霊匣	名詞	オリジン
いかいろ	異界炉	名詞	
いかいろけいかく	異界炉計画	名詞	
いかいしょう	異界省	名詞	
しぇる	断界殻	名詞	
だんかいかく	断界殻	名詞	シェル
だんかいから	断界殻	名詞	シェル
うるすかーら	世精ノ途	名詞	
よせいのみち	世精ノ途	名詞	ウルスカーラ
うるすらーん	世精ノ果テ	名詞	
よせいのはて	世精ノ果テ	名詞	ウルスラーン
せいれいかい	精霊界	名詞	
ぶーすたー	増霊極	名詞	
ぞうれいきょく	増霊極	名詞	ブースター
じんてくす	算譜法	名詞	
さんふほう	算譜法	名詞	ジンテクス
こんだくたー	指揮者	名詞	
こんだくたーいるべると	指揮者イルベルト	名詞	
しきしゃ	指揮者	名詞	コンダクター
ふぉーう゛	四象刃	名詞	
ふぉーぶ	四象刃	名詞	
ふぉーゔ	四象刃	名詞	
よんぞうじん	四象刃	名詞	フォーヴ
しぞうじん	四象刃	名詞	フォーヴ
ろーたす	蓮華陣	名詞	
れんかじん	蓮華陣	名詞	ロータス
まぐな・ぜろ	マグナ・ゼロ	名詞	
まぐなぜろ	マグナ・ゼロ	名詞	
おうごんまけんし	黄金魔剣士	名詞	
せいし	正史	名詞	
せいしせかい	正史世界	名詞	
ぶんし	分史	名詞	
ぶんしせかい	分史世界	名詞	
たいむふぁくたー	時歪の因子	名詞	
がいかく	骸殻	名詞	
じわいのいんし	時歪の因子	名詞	
じゅれいじゅつ	呪霊術	名詞	
かいばくげんま	海瀑幻魔	名詞	
むめいのれいい	無明の霊異	名詞	
りーゔあさると	リーヴアサルト	名詞	
りーう゛あさると	リーヴアサルト	名詞	
りーぶあさると	リーヴアサルト	名詞	
りんくひおうぎ	共鳴秘奥義	名詞	
しいなごう	椎名豪	名詞	
しいなまさる	椎名豪	名詞	
なかざわかずと	中澤一登	名詞	
おくむらだいご	奥村大悟	名詞	
うどう	有働	名詞	
うどうたつろう	有働龍郎	名詞	ウドッチ
うどっち	ウドッチ	名詞	
しんめんじーのしん	新免Ｇ之進	名詞	
しんめんGのしん	新免Ｇ之進	名詞	
しんめんgのしん	新免Ｇ之進	名詞	
たむらしんじ	田村信二	名詞	
あおやまひびき	青山響	名詞	田村信二
たむらひろし	田村宏史	名詞	
ばばひでお	馬場英雄	名詞	
ひぐちよしひと	樋口義人	名詞	
おおだて	大舘	名詞	
おおだて	大舘隆司	名詞	
おおだてりゅうじ	大舘隆司	名詞	
よしだゆかり	吉田由香里	名詞	
にゅーしねまとかげ	New Cinema 蜥蜴	名詞	
