まじんけん	魔神剣	名詞	
ひえんれんきゃく	飛燕連脚	名詞	
しゅうそうらいざん	襲爪雷斬	名詞	
あきさざめ	秋沙雨	名詞	
こがはざん	虎牙破斬	名詞	
じゅうしょうらい	柔招来	名詞	
ほうおうてんく	鳳凰天駆	名詞	
しゅごほうじん	守護方陣	名詞	
しんくうはざん	真空破斬	名詞	
しゅうきほう	集気法	名詞	
ししせんこう	獅子戦吼	名詞	
ごうしょうらい	剛招来	名詞	
せんくうれつは	閃空裂破	名詞	
せんくうれっぱ	閃空裂破	名詞	
ぐれんけん	紅蓮剣	名詞	
こくうそうはざん	虚空蒼破斬	名詞	
くうかんしょうてんい	空間翔転移	名詞	
じげんざん	次元斬	名詞	
さつげきぶこうけん	殺劇舞荒剣	名詞	
まじんひえんきゃく	魔神飛燕脚	名詞	
まじんそうはざん	魔神双破斬	名詞	
まじんせんれつは	魔神千裂破	名詞	TOP クレスが使用
まじんせんれっぱ	魔神千裂破	名詞	TOP クレスが使用
まじんせんくうは	魔神閃空破	名詞	
ししひえんきゃく	獅子飛燕脚	名詞	
ししこうはざん	獅子吼破斬	名詞	
ししせんれつは	獅子千裂破	名詞	
ししせんれっぱ	獅子千裂破	名詞	
ししせんくうは	獅子閃空破	名詞	
しゅうそうひえんきゃく	襲爪飛燕脚	名詞	
しゅうそうらいざんは	襲爪雷斬破	名詞	
しゅうそうせんれつは	襲爪千裂破	名詞	
しゅうそうせんれっぱ	襲爪千裂破	名詞	
しゅうそうせんくうは	襲爪閃空破	名詞	
ほうおうてんしょうきゃく	鳳凰天翔脚	名詞	
ほうおうしょうはざん	鳳凰翔破斬	名詞	
ほうおうせんれつは	鳳凰千裂破	名詞	
ほうおうせんれっぱ	鳳凰千裂破	名詞	
ほうおうてんくうは	鳳凰天空破	名詞	
じくうそうはざん	時空蒼破斬	名詞	
てんいそうはざん	転移蒼破斬	名詞	
めいくうざんしょうけん	冥空斬翔剣	名詞	
ぴこはん	ピコハン	名詞	
ぐれいう゛	グレイヴ	名詞	
ぐれいゔ	グレイヴ	名詞	
ぐれん	紅蓮	名詞	
とうが	凍牙	名詞	
ごうてん	轟天	名詞	
しょうは	衝破	名詞	TOP チェスター、ToD チェルシーが使用
しんてん	震天	名詞	
しゅうう	鷲羽	名詞	
はやて	疾風	名詞	
たいが	大牙	名詞	
とりゅう	屠龍	名詞	
うつしみ	写身	名詞	
しらぬい	不知火	名詞	
いづなおとし	飯綱落とし	名詞	
はがくれ	葉隠	名詞	
まんじゅしゃげ	曼珠沙華	名詞	TOP すずが使用
らいでん	雷電	名詞	
かまいたち	鎌鼬	名詞	
さみだれ	五月雨	名詞	
じらいや	児雷也	名詞	
もうこれんげきは	猛虎連撃破	名詞	
まるくてきいろいすごいやつ	丸くて黄色いすごいヤツ	名詞	
らいが	雷牙	名詞	
どくしゅけん	毒手拳	名詞	
にれんざん	二連斬	名詞	
さんれんざん	三連斬	名詞	
いっとうりょうだん	一刀両断	名詞	
せきかこうせん	石化光線	名詞	
りんごらんぶ	リンゴ乱舞	名詞	
ひめい	悲鳴	名詞	
らいこうは	雷光破	名詞	
ばくえんしゅう	爆炎襲	名詞	
かがみうち	鏡討ち	名詞	
ちょとつもうしん	猪突猛進	名詞	
どこんじょうじゃんぷ	ド根性ジャンプ	名詞	
れつくうざん	烈空斬	名詞	ToD スタン、TOH クンツァイト、マイソロ2、3、TOVS カイウス、なりダンX メルが使用
れっくうざん	烈空斬	名詞	ToD スタン、TOH クンツァイト、マイソロ2、3、TOVS カイウス、なりダンX メルが使用
だんくうけん	断空剣	名詞	
そうりゅうれんがざん	爪竜連牙斬	名詞	
くうがしょうりゅうきゃく	空牙昇竜脚	名詞	
ねつはせんぷうじん	熱破旋風陣	名詞	ToD スタンが使用
ねっぱせんぷうじん	熱破旋風陣	名詞	ToD スタンが使用
まおうえんげきは	魔王炎撃波	名詞	ToD スタン、TOA ガイ、TOH コハク、ToG アスベル、TOX ウィンガルが使用
しこうばくえんじん	獅吼爆炎陣	名詞	
こうおうてんしょうよく	皇王天翔翼	名詞	ToD スタンが使用
まじんけんしょうが	魔神剣・翔牙	名詞	
まじんけん・しょうが	魔神剣・翔牙	名詞	
しんくうれつざん	真空裂斬	名詞	
ばくえんけん	爆炎剣	名詞	
とりゅうせん	屠龍閃	名詞	
しゃっこうけん	灼光拳	名詞	
しゃくこうけん	灼光拳	名詞	
そうはじん	蒼破刃	名詞	
せんこうれつは	閃光裂破	名詞	
せんこうれっぱ	閃光裂破	名詞	
しょうおうれっか	翔凰烈火	名詞	
ひょうげつしょうせん	氷月翔閃	名詞	
れつしんてんしょう	烈震天衝	名詞	ToD スタン、TOA ルーク、アッシュ、TOX ジャオが使用
れっしんてんしょう	烈震天衝	名詞	ToD スタン、TOA ルーク、アッシュ、TOX ジャオが使用
ひおうぜつえんしょう	緋凰絶炎衝	名詞	
ごうまかいじんけん	業魔灰燼剣	名詞	
ざんくうてんしょうけん	斬空天翔剣	名詞	
えすけーぷえあ	エスケープ・エア	名詞	
えすけーぷ・えあ	エスケープ・エア	名詞	
ぶらっでぃろーず	ブラッディローズ	名詞	ToD ルーティ、ToV ジュディスが使用
くうしゅうけん	空襲剣	名詞	
まりあん	魔人闇	名詞	
まじんやみ	魔人闇	名詞	マリアン
まじんあん	魔人闇	名詞	マリアン
まじんえん	魔人闇	名詞	マリアン
まりあん	マリアン	名詞	
まじんけんそうが	魔神剣・双牙	名詞	
まじんけん・そうが	魔神剣・双牙	名詞	
ひえんれんざん	飛燕連斬	名詞	
そうがざん	双牙斬	名詞	
がりゅうせん	臥竜閃	名詞	
がりゅうめつは	臥竜滅破	名詞	
がりゅうめっぱ	臥竜滅破	名詞	
げんえいじん	幻影刃	名詞	
げつせんこう	月閃光	名詞	
げっせんこう	月閃光	名詞	
げつせんこほう	月閃虚崩	名詞	
げっせんこほう	月閃虚崩	名詞	
ほうりゅうざんこうけん	崩龍斬光剣	名詞	
まじんめつさつえん	魔人滅殺闇	名詞	
まじんめっさつえん	魔人滅殺闇	名詞	
じょうはめつしょうえん	浄破滅焼闇	名詞	
じょうはめっしょうえん	浄破滅焼闇	名詞	
まじんれんごくさつ	魔神煉獄殺	名詞	ToD リオンが使用
がりゅうざんげつ	臥竜斬月	名詞	
まじんけんせつが	魔神剣・刹牙	名詞	
まじんけん・せつが	魔神剣・刹牙	名詞	
でもんずらんすぜろ	デモンズランス・ゼロ	名詞	
でもんずらんす・ぜろ	デモンズランス・ゼロ	名詞	
せつが	刹牙	名詞	
ごうれつ	豪烈	名詞	
ふうじんけん	風神剣	名詞	ToD ウッドロウ、ToR ヴェイグが使用
かげろう	陽炎	名詞	
はくう	雹雨	名詞	
れつくうじん	烈空刃	名詞	ToD ウッドロウが使用
れっくうじん	烈空刃	名詞	ToD ウッドロウが使用
こうれんしょう	煌憐昇	名詞	
ばつさいが	抜砕牙	名詞	
ばっさいが	抜砕牙	名詞	
せつな	刹那	名詞	
くうはぜつしょうげき	空破絶掌撃	名詞	
くうはぜっしょうげき	空破絶掌撃	名詞	
ぜつえい	絶影	名詞	
こふう	虚封	名詞	
きょふう	虚封	名詞	コフウ
れつしょうそうはじん	裂衝蒼破塵	名詞	
れっしょうそうはじん	裂衝蒼破塵	名詞	
こうぶせんこうせん	皇舞旋煌閃	名詞	
せつかざん	刹華斬	名詞	
せっかざん	刹華斬	名詞	
すとっぷふろぅ	ストップフロゥ	名詞	PS1版ToD フィリアが使用
すとっぷふろう	ストップフロゥ	名詞	PS1版ToD フィリアが使用
すとっぷふろう	ストップフロウ	名詞	
もうしゅうけん	猛襲剣	名詞	
まじんけんかい	魔神剣・改	名詞	
まじんけん・かい	魔神剣・改	名詞	
ごうらいけん	剛雷剣	名詞	
ごうまじんけん	剛・魔神剣	名詞	
ごう・まじんけん	剛・魔神剣	名詞	
れつまじんけん	烈・魔神剣	名詞	
れつ・まじんけん	烈・魔神剣	名詞	
ざん	斬！	名詞	ToD マリーが使用
ざん!	斬！	名詞	ToD マリーが使用
しつとうしゅう	疾刀蹴	名詞	
しっとうしゅう	疾刀蹴	名詞	
しゅんじんろうが	瞬刃狼牙	名詞	
せんほうしょう	旋鳳衝	名詞	
ほうついしょう	崩槌鐘	名詞	ToD マリー、ラタトスクの騎士 リーガルが使用
ししおうめつさい	獅子王滅砕	名詞	
ししおうめっさい	獅子王滅砕	名詞	
かつはばくそうげき	割破爆走撃	名詞	
かっぱばくそうげき	割破爆走撃	名詞	
しんごうらいけん	真・剛雷剣	名詞	
しん・ごうらいけん	真・剛雷剣	名詞	
ばくじんきょうさつ	爆神狂刹	名詞	
しんらばくさい	森羅爆砕	名詞	
しんらばっさい	森羅爆砕	名詞	
じんらい	迅雷	名詞	
してんめつさつ	死天滅殺	名詞	
してんめっさつ	死天滅殺	名詞	
してんめつさつきゅう	死天滅殺弓	名詞	
してんめっさつきゅう	死天滅殺弓	名詞	
しゃよう	斜陽	名詞	
しゅれん	朱蓮	名詞	
ひえん	飛燕	名詞	
げつか	月華	名詞	
げっか	月華	名詞	
せいは	星覇	名詞	
らせん	螺旋	名詞	
しらなぎとうが	白薙・凍華	名詞	
しらなぎ・とうが	白薙・凍華	名詞	
わいるどぎーす	ワイルドギース	名詞	ToD チェルシー、TOA闘技場ナナリー、マイソロ3 ナナリーが使用
わいるどぎーす	ワイルド・ギース	名詞	ToD2 ナナリーが使用
わいるど・ぎーす	ワイルド・ギース	名詞	ToD2 ナナリーが使用
あたるしんふぉにー	あたるシンフォニー	名詞	
ごーごーさんば	ごーごーサンバ	名詞	
かわせまーち	かわせマーチ	名詞	
しびれるんば	しびれルンバ	名詞	
ねむれららばい	ねむれララバイ	名詞	
なかよしわるつ	なかよしワルツ	名詞	
まわれろんど	まわれロンド	名詞	
じぇいりさいたる	J.リサイタル	名詞	ToD 没技
じょにーりさいたる	J.リサイタル	名詞	ToD 没技
jりさいたる	J.リサイタル	名詞	ToD 没技
らいじんけん	雷神拳	名詞	
らいじんじゅうれんげき	雷神十連撃	名詞	ToD リリスが使用
しこうばくらいじん	獅吼爆雷陣	名詞	
ししゃのめざめ	死者の目覚め	名詞	
まんぼうせんこう	まんぼう戦吼	名詞	
まんぼうすとらいど	まんぼうストライド	名詞	
れいんてぃぶおりおん	レインティブ・オリオン	名詞	
れいんてぃぶ・おりおん	レインティブ・オリオン	名詞	
さばいう゛ぃんぐほりん	サバイヴィング・ホリン	名詞	
さばいう゛ぃんぐ・ほりん	サバイヴィング・ホリン	名詞	
さばいゔぃんぐほりん	サバイヴィング・ホリン	名詞	
さばいゔぃんぐ・ほりん	サバイヴィング・ホリン	名詞	
せれすてぃあるあーす	セレスティアル・アース	名詞	
せれすてぃある・あーす	セレスティアル・アース	名詞	
しとつそうけん	刺突爪拳	名詞	
そうしんりゅうげき	爪辰流撃	名詞	
ちょうはどうだん	超波動弾	名詞	
ざんほうけん	斬崩剣	名詞	
ざんこうけん	斬光剣	名詞	
かっしんづき	活心突き	名詞	
かつしんづき	活心突き	名詞	
てんちなげ	天地投げ	名詞	
がふうせん	臥封閃	名詞	
いっせん	一閃	名詞	
れんざんは	連斬破	名詞	
ちょうれんざんは	超連斬破	名詞	
しょうりゅうざんは	昇竜斬波	名詞	
しょうはげきとつけん	衝波激突剣	名詞	
ごうてんさいは	豪天砕破	名詞	
じゅうごうしょうらい	重剛招来	名詞	
りんねめつしょう	輪廻滅衝	名詞	
りんねめっしょう	輪廻滅衝	名詞	
まじんえん	魔神炎	名詞	
はどうめつぷう	覇道滅封	名詞	
はどうめっぷう	覇道滅封	名詞	
はどうめつふう	覇道滅封	名詞	
こがくうべつばら	虎が食う別腹	名詞	
とらがくうべつばら	虎が食う別腹	名詞	
ひゃっほうへき	ひゃっほう壁	名詞	
らんぶりんぐ	乱舞りんぐ	名詞	
ですあびす	デス・アビス	名詞	
です・あびす	デス・アビス	名詞	
さつまじんけん	殺・魔神剣	名詞	
さつ・まじんけん	殺・魔神剣	名詞	
あいてむなぞつかってんじゃねえ	ア イ テ ム な ぞ 使 っ て ん じ ゃ ね え ！	名詞	ToD バルバトスが使用
あいてむなぞつかってんじゃねぇ	ア イ テ ム な ぞ 使 っ て ん じ ゃ ね え ！	名詞	ToD バルバトスが使用
あいてむなぞつかってんじゃねえ!	ア イ テ ム な ぞ 使 っ て ん じ ゃ ね え ！	名詞	ToD バルバトスが使用
あいてむなぞつかってんじゃねぇ!	ア イ テ ム な ぞ 使 っ て ん じ ゃ ね え ！	名詞	ToD バルバトスが使用
あいてむなぞ	ア イ テ ム な ぞ 使 っ て ん じ ゃ ね え ！	名詞	ToD バルバトスが使用
じふにーと	自負ニート	名詞	
らいじんけん	雷神剣	名詞	
ちりさざめ	散沙雨	名詞	
れつくうざん	裂空斬	名詞	
れっくうざん	裂空斬	名詞	
ふうらいじんけん	風雷神剣	名詞	
こがれんざん	虎牙連斬	名詞	
らいじんそうはざん	雷神双破斬	名詞	
まじんせんれつは	魔神千烈破	名詞	ToE リッドが使用
まじんせんれっぱ	魔神千烈破	名詞	ToE リッドが使用
まじんれんがざん	魔神連牙斬	名詞	
せんくうそうはざん	閃空双破斬	名詞	
しょううれつくうげき	翔雨裂空撃	名詞	ToE リッドが使用
しょううれっくうげき	翔雨裂空撃	名詞	ToE リッドが使用
せんくうしょうれつは	閃空翔裂破	名詞	ToE リッド、TOA ガイが使用
せんくうしょうれっぱ	閃空翔裂破	名詞	ToE リッド、TOA ガイが使用
ふうじんばくふう	風刃縛封	名詞	
ふうじんふうばくさつ	風塵封縛殺	名詞	
きょくこうへき	極光壁	名詞	
きょっこうへき	極光壁	名詞	
きょくこうけん	極光剣	名詞	
きょっこうけん	極光剣	名詞	
きょくこうは	極光波	名詞	
きょっこうは	極光波	名詞	
きょくこう	極光	名詞	
きょっこう	極光	名詞	
りゅうこめつがざん	龍虎滅牙斬	名詞	
えたーなるふぁいなりてぃ	エターナル・ファイナリティ	名詞	ToE シゼルが使用
えたーなる・ふぁいなりてぃ	エターナル・ファイナリティ	名詞	ToE シゼルが使用
えたーなるいんふぃにてぃ	エターナル・インフィニティ	名詞	
えたーなる・いんふぃにてぃ	エターナル・インフィニティ	名詞	
しんえんなるきょくげんのやみ	-深淵なる極限の闇-	名詞	
ふぁいなりてぃでっどえんど	ファイナリティ・デッドエンド	名詞	
ふぁいなりてぃ・でっどえんど	ファイナリティ・デッドエンド	名詞	
つむがれしひかりのはどう	-紡がれし光の波動-	名詞	
いんふぃにてぃりう゛ぁいう゛ぁー	インフィニティ・リヴァイヴァー	名詞	
いんふぃにてぃ・りう゛ぁいう゛ぁー	インフィニティ・リヴァイヴァー	名詞	
いんふぃにてぃりゔぁいゔぁー	インフィニティ・リヴァイヴァー	名詞	
いんふぃにてぃ・りゔぁいゔぁー	インフィニティ・リヴァイヴァー	名詞	
しょうていは	掌底破	名詞	
さざんか	三散華	名詞	
れんがだん	連牙弾	名詞	
がりょうくうは	臥龍空破	名詞	
ようそうしゅうげき	鷹爪蹴撃	名詞	ToE ファラ、TOS リーガルが使用
てんけつばくたい	点穴縛態	名詞	
さんかもうしゅうきゃく	散華猛襲脚	名詞	ToE ファラが使用
ひえんれんてんきゃく	飛燕連天脚	名詞	
そうどうしょうていは	双撞掌底破	名詞	
ひようほんぽ	飛葉翻歩	名詞	
はちようれんが	八葉連牙	名詞	
ようそうらくばくしゅう	鷹爪落瀑蹴	名詞	
さつげきぶこうけん	殺劇舞荒拳	名詞	ToE ファラ、TOA アニス、TOH コハクが使用
しこうばくさいじん	獅吼爆砕陣	名詞	
かりゅうえんぶ	火龍炎舞	名詞	
げどくこう	解毒功	名詞	
ちゆこう	治癒功	名詞	
かいせいこう	回生功	名詞	
そうりゅうざんこうけん	爪竜斬光剣	名詞	
かいりゅうけん	海龍拳	名詞	
らいせんけん	雷閃拳	名詞	
こつじんけん	骨人剣	名詞	
こつじんよんれんげき	骨人四連撃	名詞	
ひでんれんきゃく	秘伝連脚	名詞	
ひょうしゅうれんげき	氷襲連撃	名詞	
とうじんじゅうれんげき	凍刃十連撃	名詞	
きしゃさざめ	キシャ沙雨	名詞	
はなさざめ	鼻沙雨	名詞	
こうおうてんしょうよく	皇王天翔浴	名詞	ToE ノームが使用
しゅんべつのふくりゅう	峻別の伏流	名詞	
せんれいのほこやり	洗礼の矛槍	名詞	
おしょくじちゅう	お食事中	名詞	
ぐれいび	グレイ鼻	名詞	
とおぐれいび	遠グレイ鼻	名詞	
えんぐれいび	遠グレイ鼻	名詞	
らいげき	雷撃	名詞	
ほうでん	放電	名詞	
だんかつ	弾割	名詞	
はじきわり	弾割	名詞	
はどうしょう	波動掌	名詞	
ほうおうけん	鳳凰拳	名詞	
ししんらんぶ	四神乱舞	名詞	
れぐるすらんぶ	レグルス乱舞	名詞	
てんかむそうけん	天下無双剣	名詞	
てんしんれんげき	転身連撃	名詞	
わるきゅりあすとらいく	ワルキュリア・ストライク	名詞	
わるきゅりあ・すとらいく	ワルキュリア・ストライク	名詞	
わるきゅりあせいばー	ワルキュリア・セイバー	名詞	
わるきゅりあ・せいばー	ワルキュリア・セイバー	名詞	
でゅあるざさん	デュアル・ザ・サン	名詞	
でゅある・ざ・さん	デュアル・ザ・サン	名詞	
えたにてぃすぉーむ	エタニティ・スォーム	名詞	
えたにてぃ・すぉーむ	エタニティ・スォーム	名詞	
ぷりずみっくすたーず	プリズミックスターズ	名詞	ToE晶霊術、TOS複合特技
ぶらいてぃすとげーと	ブライティスト・ゲート	名詞	
ぶらいてぃすと・げーと	ブライティスト・ゲート	名詞	
えくすぷろーじょんのう゛ぁ	エクスプロージョン・ノヴァ	名詞	
えくすぷろーじょん・のう゛ぁ	エクスプロージョン・ノヴァ	名詞	
えくすぷろーじょんのゔぁ	エクスプロージョン・ノヴァ	名詞	
えくすぷろーじょん・のゔぁ	エクスプロージョン・ノヴァ	名詞	
まくすうぇるろあー	マクスウェル・ロアー	名詞	
まくすうぇる・ろあー	マクスウェル・ロアー	名詞	
でぃめんじょなるまてりある	ディメンジョナル・マテリアル	名詞	
でぃめんじょなる・まてりある	ディメンジョナル・マテリアル	名詞	
ぶるーあーす	ブルー・アース	名詞	ToE晶霊術
ぶるー・あーす	ブルー・アース	名詞	ToE晶霊術
でぃーぷふぁんとむ	ディープ・ファントム	名詞	
でぃーぷ・ふぁんとむ	ディープ・ファントム	名詞	
ほりでーしんふぉにー	ホリデー・シンフォニー	名詞	
ほりでー・しんふぉにー	ホリデー・シンフォニー	名詞	
とらんすしんふぉにー	トランス・シンフォニー	名詞	
とらんす・しんふぉにー	トランス・シンフォニー	名詞	
きょうげき	強撃	名詞	
おたけび	雄叫び	名詞	
うけながし	受け流し	名詞	
みねうち	刀背打ち	名詞	
ぼうえいへき	防衛壁	名詞	
はんいちょうはつ	範囲挑発	名詞	
いしきこうじょう	意識向上	名詞	
しんがん	心眼	名詞	
ゆうおう	勇往	名詞	
しんき	神気	名詞	
さんちん	三戦	名詞	
いぶき	息吹	名詞	
たんけい	短勁	名詞	
せいりゅうのまい	清流の舞	名詞	
しっぷうのまい	疾風の舞	名詞	
しんきゃく	震脚	名詞	
かてんのまい	華天の舞	名詞	
そうはついれん	蒼破追蓮	名詞	
ちりはじん	散葉塵	名詞	
ちりはかれは	散葉枯葉	名詞	
くうしょうざん	空翔斬	名詞	
くうしょうれつふう	空翔裂風	名詞	ToD2 カイルが使用
くうしょうれつぷう	空翔裂風	名詞	ToD2 カイルが使用
くうしょうれっぷう	空翔裂風	名詞	ToD2 カイルが使用
ばくえんれんしょう	爆炎連焼	名詞	
せんこうしょう	閃光衝	名詞	
せんこうしょうつい	閃光翔墜	名詞	
がれんそうはじん	牙連蒼破刃	名詞	
くうはぜつふうげき	空破絶風撃	名詞	
くうはぜっぷうげき	空破絶風撃	名詞	
とりゅうれんげきは	屠龍連撃破	名詞	
しつくうれんさつけん	疾空連殺剣	名詞	
しっくうれんさつけん	疾空連殺剣	名詞	
がんざんめつさいじん	岩斬滅砕陣	名詞	
がんざんめっさいじん	岩斬滅砕陣	名詞	
ぜつはめつしょうげき	絶破滅焼撃	名詞	
ぜっぱめっしょうげき	絶破滅焼撃	名詞	
そうりゅうめつがざん	蒼龍滅牙斬	名詞	
しょうおうぜつれんしょう	翔王絶憐衝	名詞	
そうだしょう	双打鐘	名詞	
そうだれんしゅう	双打連蹴	名詞	
らいじんしょう	雷神招	名詞	
らいじんこうりん	雷神光燐	名詞	
ほうついしょう	放墜鐘	名詞	ToD2 ロニが使用
ほうついほうつい	放墜砲鎚	名詞	
むひょうしょう	霧氷翔	名詞	
むひょうついせん	霧氷鎚閃	名詞	
ばくかいしょう	爆灰鐘	名詞	
ばっかいしょう	爆灰鐘	名詞	
ばくかいもうつい	爆灰猛追	名詞	
ばっかいもうつい	爆灰猛追	名詞	
くうはとっこうだん	空破特攻弾	名詞	
せんこうばっぱ	戦吼爆ッ破	名詞	
しんくうかつさいじん	神空割砕人	名詞	
しんくうかっさいじん	神空割砕人	名詞	
しんてんれっくう	震天裂空斬光旋風滅砕神罰割殺撃	名詞	
しんてんれっくう	震天裂空斬光旋風滅砕神罰攻撃	名詞	
しんてんれつくう	震天裂空斬光旋風滅砕神罰割殺撃	名詞	
しんてんれつくう	震天裂空斬光旋風滅砕神罰攻撃	名詞	
しんてんれっくう	震天裂空斬光（略）	名詞	
しんてんれつくう	震天裂空斬光（略）	名詞	
しんてんれっくう	シェイクスプリットスラッシュウィンドクラッシュパニッシュディバイドエンド	名詞	
しんてんれつくう	シェイクスプリットスラッシュウィンドクラッシュパニッシュディバイドエンド	名詞	
しんてんれっくう	ｼｪｲｸｽﾌﾟﾘｯﾄｽﾗｯｼｭｳｨﾝﾄﾞｸﾗｯｼｭﾊﾟﾆｯｼｭﾃﾞｨﾊﾞｲﾄﾞｴﾝﾄﾞ	名詞	
しんてんれつくう	ｼｪｲｸｽﾌﾟﾘｯﾄｽﾗｯｼｭｳｨﾝﾄﾞｸﾗｯｼｭﾊﾟﾆｯｼｭﾃﾞｨﾊﾞｲﾄﾞｴﾝﾄﾞ	名詞	
しんてんれつくうざんこうせんぷうめつさいしんばつかつさつげき	震天裂空斬光旋風滅砕神罰割殺撃	名詞	
しんてんれっくうざんこうせんぷうめっさいしんばつかっさつげき	震天裂空斬光旋風滅砕神罰割殺撃	名詞	
しんてんれつくうざんこうせんぷうめつさいしんばつこうげき	震天裂空斬光旋風滅砕神罰攻撃	名詞	
しんてんれっくうざんこうせんぷうめっさいしんばつこうげき	震天裂空斬光旋風滅砕神罰攻撃	名詞	
しんてんれつくうざんこうせんぷうめつさいしんばつかつさつげき	震天裂空斬光（略）	名詞	
しんてんれっくうざんこうせんぷうめっさいしんばつかっさつげき	震天裂空斬光（略）	名詞	
しんてんれっくうざんこうせんぷうめっさいしんばつかっさつげき	シェイクスプリットスラッシュウィンドクラッシュパニッシュディバイドエンド	名詞	
しんてんれっくうざんこうせんぷうめっさいしんばつかっさつげき	ｼｪｲｸｽﾌﾟﾘｯﾄｽﾗｯｼｭｳｨﾝﾄﾞｸﾗｯｼｭﾊﾟﾆｯｼｭﾃﾞｨﾊﾞｲﾄﾞｴﾝﾄﾞ	名詞	
しんてんれつくうざんこうせんぷうめつさいしんばつかつさつげき	シェイクスプリットスラッシュウィンドクラッシュパニッシュディバイドエンド	名詞	
しんてんれつくうざんこうせんぷうめつさいしんばつかつさつげき	ｼｪｲｸｽﾌﾟﾘｯﾄｽﾗｯｼｭｳｨﾝﾄﾞｸﾗｯｼｭﾊﾟﾆｯｼｭﾃﾞｨﾊﾞｲﾄﾞｴﾝﾄﾞ	名詞	
しぇいくすぷりっとすらっしゅうぃんどくらっしゅぱにっしゅでぃばいどえんど	震天裂空斬光旋風滅砕神罰割殺撃	名詞	
しぇいくすぷりっとすらっしゅういんどくらっしゅぱにっしゅでぃばいどえんど	震天裂空斬光旋風滅砕神罰割殺撃	名詞	
しぇいくすぷりっと	震天裂空斬光旋風滅砕神罰割殺撃	名詞	
しぇいくすぷりっと	震天裂空斬光（略）	名詞	
しぇいくすぷりっと	ｼｪｲｸｽﾌﾟﾘｯﾄｽﾗｯｼｭｳｨﾝﾄﾞｸﾗｯｼｭﾊﾟﾆｯｼｭﾃﾞｨﾊﾞｲﾄﾞｴﾝﾄﾞ	名詞	
しぇいくすぷりっと	シェイクスプリットスラッシュウィンドクラッシュパニッシュディバイドエンド	名詞	
ひれんざん	飛連斬	名詞	
ひれんそうせん	飛連双閃	名詞	
そうれんげき	双連撃	名詞	
そうれんしょうは	双連衝破	名詞	
げんえいかいき	幻影回帰	名詞	
せんれつここうせん	千裂虚光閃	名詞	
まじんせんれつしょう	魔人千裂衝	名詞	
ふんじんれつはしょう	粉塵裂破衝	名詞	
ふんじんれっぱしょう	粉塵裂破衝	名詞	
しょうはれつこうせん	翔破裂光閃	名詞	
しょうはれっこうせん	翔破裂光閃	名詞	
ぎれんしょうれいざん	義憐聖霊斬	名詞	
まじんれんごくさつ	真神煉獄刹	名詞	ToD2 ジューダスが使用
てんしょうだん	天翔弾	名詞	
ふうじんしょう	風神招	名詞	
ごほうれん	護法蓮	名詞	
りゅうれんだん	流蓮弾	名詞	ToD2 リアラが使用
れつかせん	烈火閃	名詞	
れっかせん	烈火閃	名詞	
がれんせん	牙連閃	名詞	
せんひょうせん	扇氷閃	名詞	
ついようせん	墜陽閃	名詞	
こくうせん	虚空閃	名詞	
りゅうえんせん	龍炎閃	名詞	
らいがしょう	雷牙衝	名詞	
かれんげき	華連撃	名詞	
えいせんけん	影閃剣	名詞	
きょうえいそう	鏡影槍	名詞	
とぅいんくるすたー	トゥインクル・スター	名詞	
とぅいんくる・すたー	トゥインクル・スター	名詞	
みっくすますたー	ミックス・マスター	名詞	
みっくす・ますたー	ミックス・マスター	名詞	
ぷりんせすおぶまーめいど	プリンセス・オブ・マーメイド	名詞	ToD2 ハロルド、TOH-R ベリルが使用
ぷりんせす・おぶ・まーめいど	プリンセス・オブ・マーメイド	名詞	ToD2 ハロルド、TOH-R ベリルが使用
かってにすぺくたくるず	勝手にスペクタクルズ	名詞	
しゅんらいじん	瞬雷刃	名詞	
らいはざん	雷破斬	名詞	
らいざんごうてんげき	雷斬轟天撃	名詞	
ごりんざん	五輪斬	名詞	
しんがんむのたち	心眼・無の太刀	名詞	
しんがん・むのたち	心眼・無の太刀	名詞	
しんがんむのたちれん	心眼・無の太刀・連	名詞	
しんがん・むのたち・れん	心眼・無の太刀・連	名詞	
ばっとうれつしょうが	抜刀・裂衝牙	名詞	
ばっとうれっしょうが	抜刀・裂衝牙	名詞	
ばっとう・れつしょうが	抜刀・裂衝牙	名詞	
ばっとう・れっしょうが	抜刀・裂衝牙	名詞	
れっしょうが	裂衝牙	名詞	
れつしょうが	裂衝牙	名詞	
ごうえんざん	轟炎斬	名詞	
ざんくうだん	斬空断	名詞	
れつさいだん	裂砕断	名詞	
れっさいだん	裂砕断	名詞	
さんれんさつ	三連殺	名詞	
さんれんさつ	轟炎斬	名詞	ゴウエンザン
さんれんさつ	斬空断	名詞	ザンクウダン
さんれんさつ	裂砕断	名詞	レッサイダン
らすとう゛ぁにっしゃー	ラスト・ヴァニッシャー	名詞	
らすと・う゛ぁにっしゃー	ラスト・ヴァニッシャー	名詞	
らすとゔぁにっしゃー	ラスト・ヴァニッシャー	名詞	
らすと・ゔぁにっしゃー	ラスト・ヴァニッシャー	名詞	
いんでぃぐねいとじゃっじめんと	インディグネイト・ジャッジメント	名詞	
いんでぃぐねいと・じゃっじめんと	インディグネイト・ジャッジメント	名詞	
ぽいぞにっくふぃーるど	ポイゾニック・フィールド	名詞	
ぽいぞにっく・ふぃーるど	ポイゾニック・フィールド	名詞	
りゅうみゃく	竜脈	名詞	
けんじゃのいし	賢者の石	名詞	
えいちのろんど	英知のロンド	名詞	
ひっちゅうのふーが	必中のフーガ	名詞	
ふだんのぱすとらる	不断のパストラル	名詞	
ごうりきのおらとりお	剛力のオラトリオ	名詞	
らすてぃねいる	ラスティ・ネイル	名詞	
らすてぃ・ねいる	ラスティ・ネイル	名詞	
ろすとせらふぃ	ロスト・セラフィ	名詞	
ろすと・せらふぃ	ロスト・セラフィ	名詞	
るーんうるず	ルーン・ウルズ	名詞	
るーん・うるず	ルーン・ウルズ	名詞	
るーんあるぎず	ルーン・アルギズ	名詞	
るーん・あるぎず	ルーン・アルギズ	名詞	
あいすれくいえむ	アイス・レクイエム	名詞	
あいす・れくいえむ	アイス・レクイエム	名詞	
るみなすふぃーるど	ルミナス・フィールド	名詞	
るみなす・ふぃーるど	ルミナス・フィールド	名詞	
ばーにんぐさーくる	バーニング・サークル	名詞	
ばーにんぐ・さーくる	バーニング・サークル	名詞	
とむてぃっととっと	トム・ティット・トット	名詞	
とむ・てぃっと・とっと	トム・ティット・トット	名詞	
ふぁうるうぇざー	ファウル・ウェザー	名詞	
ふぁうる・うぇざー	ファウル・ウェザー	名詞	
べるせるくそーど	ベルセルク・ソード	名詞	
べるせるく・そーど	ベルセルク・ソード	名詞	
うぃずだむくらうん	ウィズダム・クラウン	名詞	
うぃずだむ・くらうん	ウィズダム・クラウン	名詞	
すないぷりんぐ	スナイプ・リング	名詞	
すないぷ・りんぐ	スナイプ・リング	名詞	
あじりてぃくろーす	アジリティ・クロース	名詞	
あじりてぃ・くろーす	アジリティ・クロース	名詞	
まこうじん	魔皇刃	名詞	
しゅんじんけん	瞬迅剣	名詞	
ふうじんけん	風迅剣	名詞	TOS勢、ToI スパーダ、なりダンX勢が使用
くうはしょう	空破衝	名詞	
そううしょう	綜雨衝	名詞	
ざんこうしぐれ	斬光時雨	名詞	
こがれつざん	虎牙烈斬	名詞	
もうこごうはざん	猛虎豪破斬	名詞	
れつざんふう	裂斬風	名詞	
れつざんぷう	裂斬風	名詞	
しこうせんは	獅吼旋破	名詞	
しこうせんぱ	獅吼旋破	名詞	
しこうしょうはじん	獅吼翔破陣	名詞	
まじんくうがしょう	魔神空牙衝	名詞	
れつふうくうがしょう	烈風空牙衝	名詞	
れっぷうくうがしょう	烈風空牙衝	名詞	
ひてんしょうく	飛天翔駆	名詞	
しこうれつふう	獅吼烈風	名詞	
しこうれっぷう	獅吼烈風	名詞	
しゅううそうはざん	驟雨双破斬	名詞	
しんくうせんれつは	真空千裂破	名詞	
しんくうせんれっぱ	真空千裂破	名詞	
すいごじん	粋護陣	名詞	
しゅんらいけん	瞬雷剣	名詞	
かえんれつくう	火炎裂空	名詞	PS2版TOS ロイド、ToI ルカが使用
かえんれっくう	火炎裂空	名詞	PS2版TOS ロイド、ToI ルカが使用
がんさいけん	岩砕剣	名詞	
てんしょうそうはざん	天翔蒼破斬	名詞	
すたーだすとくろす	スターダスト・クロス	名詞	
すたーだすと・くろす	スターダスト・クロス	名詞	
えんじぇるふぇざー	エンジェル・フェザー	名詞	
えんじぇる・ふぇざー	エンジェル・フェザー	名詞	
れでゅーすだめーじ	レデュース・ダメージ	名詞	
れでゅーす・だめーじ	レデュース・ダメージ	名詞	
ほーりーじゃっじめんと	ホーリージャッジメント	名詞	TOS コレットが使用
さんりきふ	散力符	名詞	
さんりきしょうふ	散力翔符	名詞	
さんりきせいふ	散力凄符	名詞	
ゆうげんふ	幽幻符	名詞	
ゆうげんしょうふ	幽幻翔符	名詞	
ゆうげんせいふ	幽幻凄符	名詞	
じゃこうふ	蛇拘符	名詞	
じゃこうしょうふ	蛇拘翔符	名詞	
じゃこうせいふ	蛇拘凄符	名詞	
さくりきふ	炸力符	名詞	
はまとうふ	破魔濤符	名詞	
せいきゅうふ	生吸符	名詞	
しょうきゅうふ	精吸符	名詞	
しょうりきようふ	衝力揚符	名詞	
そうめいふ	操冥符	名詞	
しょうだんふ	衝弾符	名詞	
ひょうこうしょうふ	表降晶符	名詞	
ひょうこうしょうふ	表降晶符・火	名詞	
ひょうこうしょうふ	表降晶符・水	名詞	
ひょうこうしょうふ	表降晶符・風	名詞	
ひょうこうしょうふ	表降晶符・光	名詞	
ひょうこうしょうふひ	表降晶符・火	名詞	
ひょうこうしょうふみず	表降晶符・水	名詞	
ひょうこうしょうふかぜ	表降晶符・風	名詞	
ひょうこうしょうふひかり	表降晶符・光	名詞	
ひょうこうしょうふ・ひ	表降晶符・火	名詞	
ひょうこうしょうふ・みず	表降晶符・水	名詞	
ひょうこうしょうふ・かぜ	表降晶符・風	名詞	
ひょうこうしょうふ・ひかり	表降晶符・光	名詞	
りこうしょうふ	裏降晶符	名詞	
りこうしょうふ	裏降晶符・地	名詞	
りこうしょうふ	裏降晶符・氷	名詞	
りこうしょうふ	裏降晶符・雷	名詞	
りこうしょうふ	裏降晶符・闇	名詞	
りこうしょうふち	裏降晶符・地	名詞	
りこうしょうふこおり	裏降晶符・氷	名詞	
りこうしょうふかみなり	裏降晶符・雷	名詞	
りこうしょうふやみ	裏降晶符・闇	名詞	
りこうしょうふ・ち	裏降晶符・地	名詞	
りこうしょうふ・こおり	裏降晶符・氷	名詞	
りこうしょうふ・かみなり	裏降晶符・雷	名詞	
りこうしょうふ・やみ	裏降晶符・闇	名詞	
こうれいしょうふ	降霊召符	名詞	
こうれいしょうふこりん	降霊召符・孤鈴	名詞	
こうれいしょうふ・こりん	降霊召符・孤鈴	名詞	
こりん	孤鈴	名詞	
こうれいしょうふひ	降霊召符・火	名詞	
こうれいしょうふみず	降霊召符・水	名詞	
こうれいしょうふかぜ	降霊召符・風	名詞	
こうれいしょうふひかり	降霊召符・光	名詞	
こうれいしょうふち	降霊召符・地	名詞	
こうれいしょうふこおり	降霊召符・氷	名詞	
こうれいしょうふかみなり	降霊召符・雷	名詞	
こうれいしょうふやみ	降霊召符・闇	名詞	
こうれいしょうふみなもと	降霊召符・源	名詞	
こうれいしょうふげん	降霊召符・源	名詞	
こうれいしょうふもと	降霊召符・元	名詞	
こうれいしょうふげん	降霊召符・元	名詞	
こうれいしょうふ・ひ	降霊召符・火	名詞	
こうれいしょうふ・みず	降霊召符・水	名詞	
こうれいしょうふ・かぜ	降霊召符・風	名詞	
こうれいしょうふ・ひかり	降霊召符・光	名詞	
こうれいしょうふ・ち	降霊召符・地	名詞	
こうれいしょうふ・こおり	降霊召符・氷	名詞	
こうれいしょうふ・かみなり	降霊召符・雷	名詞	
こうれいしょうふ・やみ	降霊召符・闇	名詞	
こうれいしょうふ・みなもと	降霊召符・源	名詞	
こうれいしょうふ・げん	降霊召符・源	名詞	
こうれいしょうふ・もと	降霊召符・元	名詞	
こうれいしょうふ・げん	降霊召符・元	名詞	
こうれいしょうふ・こころ	降霊召符・心	名詞	
こうれいしょうふ・しん	降霊召符・心	名詞	
こうれいしょうふこころ	降霊召符・心	名詞	
こうれいしょうふしん	降霊召符・心	名詞	
せんくうしょうれつは	閃空衝裂破	名詞	TOS クラトス、TOS ゼロス、TOA闘技場リッド、ToI スパーダ、TOX アルヴィンが使用
せんくうしょうれっぱ	閃空衝裂破	名詞	TOS クラトス、TOS ゼロス、TOA闘技場リッド、ToI スパーダ、TOX アルヴィンが使用
せんこうついじんが	閃光墜刃牙	名詞	
しゃいにんぐばいんど	シャイニング・バインド	名詞	
しゃいにんぐ・ばいんど	シャイニング・バインド	名詞	
でぃばいんじゃっじめんと	ディバイン・ジャッジメント	名詞	
でぃばいん・じゃっじめんと	ディバイン・ジャッジメント	名詞	
ばくさいざん	爆砕斬	名詞	
ばくかいれんぶ	爆壊連舞	名詞	
ばっかいれんぶ	爆壊連舞	名詞	
れんがばくさいじん	連牙爆砕迅	名詞	
ばくえんしょうは	爆焔焼破	名詞	
こげつせん	孤月閃	名詞	TOS プレセア、ToV ジュディスが使用
しょうげつそうせん	翔月双閃	名詞	
しょうぶれつげつか	翔舞烈月華	名詞	
しょうぶれつげっか	翔舞烈月華	名詞	
げつせんくうは	月閃空破	名詞	
げっせんくうは	月閃空破	名詞	
れつせんぶ	裂旋斧	名詞	
れっせんぶ	裂旋斧	名詞	
そうせんれんぶ	双旋連斧	名詞	
くうせんれんてんぶ	空旋連転斧	名詞	
がせんごうぶ	牙旋豪斧	名詞	
ほうしゅうげき	崩襲撃	名詞	
ほうしょうしゅうげき	崩昇襲撃	名詞	TOS プレセアが使用
がんさいしゅうげき	岩砕襲撃	名詞	
ほうしゅうちがくじん	崩襲地顎陣	名詞	
しこうめつりゅうせん	獅吼滅龍閃	名詞	
そうげつばくれんぶ	双月爆連舞	名詞	
ふがくしゅうさいげき	斧顎襲砕撃	名詞	
らいしゅうほうげき	雷襲崩撃	名詞	
しっぷうれつせん	疾風裂旋	名詞	
しっぷうれっせん	疾風裂旋	名詞	
ちせいじん	地精陣	名詞	
れつはえんしょうげき	烈破焔焦撃	名詞	
れっぱえんしょうげき	烈破焔焦撃	名詞	
ひえんめつしょうじん	緋焔滅焦陣	名詞	
ひえんめっしょうじん	緋焔滅焦陣	名詞	
てんげつせん	天月旋	名詞	
れつしゅうげき	裂蹴撃	名詞	
れっしゅうげき	裂蹴撃	名詞	
がろうれんとうだ	牙狼連濤打	名詞	
ようそうもうしゅうきゃく	鷹爪猛襲脚	名詞	
ようししゅうらく	鷹嘴襲落	名詞	
ひえんきゃく	飛燕脚	名詞	
ひりゅうがく	飛龍顎	名詞	
せいりゅうこう	凄龍昂	名詞	
せいはりゅうこう	凄把龍昂	名詞	
せいりゅうしょうはこう	凄龍衝破昂	名詞	
はつきちゆこう	発氣治癒功	名詞	
はっきちゆこう	発氣治癒功	名詞	
れんきちゆこう	錬気治癒功	名詞	TOS リーガルが使用
てんほうりゅう	天崩流	名詞	
てんぽうりゅう	天崩流	名詞	
さんかもうしゅうきゃく	三華猛襲脚	名詞	TOS リーガルが使用
げつかりゅうれい	月華流麗	名詞	
げっかりゅうれい	月華流麗	名詞	
ひしょうてんしゅうぶ	飛翔天襲舞	名詞	
そうりゅうれんがだん	爪竜連牙弾	名詞	
ひえんらいきゃく	飛燕雷脚	名詞	
れつえんしゅう	裂焔蹴	名詞	
ふけい	不剄	名詞	
はつ	発	名詞	
がれんぜつしゅうげき	牙連絶襲撃	名詞	
がれんぜっしゅうげき	牙連絶襲撃	名詞	
ぴこはざん	ピコ破斬	名詞	
しょうはじゅうもんじ	衝破十文字	名詞	
げんまくうがしょう	幻魔空牙衝	名詞	
ざんまくうがしょう	斬魔空牙衝	名詞	
じゃえいけん	蛇影剣	名詞	
らいせんごうてんぶ	雷旋豪転斧	名詞	
せんぷうこうは	旋風光破	名詞	
ぴこぴこほうしゅうげき	ピコピコ崩襲撃	名詞	
ぴこくうれつは	ピコ空裂破	名詞	
ぴこくうれっぱ	ピコ空裂破	名詞	
らいこうけん	雷光剣	名詞	
げんまげつえいか	幻魔月詠華	名詞	
ざんまげつえいか	斬魔月詠華	名詞	
げんまひえんきゃく	幻魔飛燕脚	名詞	
ざんまひえんきゃく	斬魔飛燕脚	名詞	
りゅうこめつがじん	龍虎滅牙陣	名詞	
ふくいん	福音	名詞	
まじょうこうふ	魔浄光符	名詞	
せんぷうれっぱ	閃風烈破	名詞	
ぶこうななれん	舞荒七連	名詞	
ぶこうひちれん	舞荒七連	名詞	
ぶこうしちれん	舞荒七連	名詞	
がんさいじん	岩砕陣	名詞	
さいはめつしょうじん	砕破滅衝陣	名詞	
さいはめっしょうじん	砕破滅衝陣	名詞	
ばくえんぶ	爆炎斧	名詞	
れんごくほうばくは	煉獄崩爆破	名詞	
れんごくほうばっぱ	煉獄崩爆破	名詞	
そうはえんれんしょう	走破焔錬衝	名詞	
こうらいげき	降雷撃	名詞	
ごほうじん	護法陣	名詞	
ふしょうじん	浮翔陣	名詞	
しげんじん	獅現陣	名詞	
やみさざめ	闇沙雨	名詞	
しょうはばくらいじん	翔破爆雷陣	名詞	
てんしょうらいざんげき	天翔雷斬撃	名詞	
ひょうそうじん	氷槍陣	名詞	
しこうひょうさいげき	獅吼氷砕撃	名詞	
せんくうとうは	閃空踏破	名詞	
おうさいげき	殴砕撃	名詞	
いんせいんせる	インセイン・セル	名詞	
いんせいん・せる	インセイン・セル	名詞	
いんふぇるのりみてっど	インフェルノ・リミテッド	名詞	
いんふぇるの・りみてっど	インフェルノ・リミテッド	名詞	
どくえき	毒液	名詞	
そうてん	爪天	名詞	
そうれんきゃく	双連脚	名詞	
すごいそうれんきゃく	すごい双連脚	名詞	
じゅうもんじぎり	十文字斬り	名詞	
じゃっじめんと・れい	ジャッジメント・レイ	名詞	
じゃっじめんとれい	ジャッジメント・レイ	名詞	
いのせんとぜろ	イノセント・ゼロ	名詞	
いのせんと・ぜろ	イノセント・ゼロ	名詞	
くうはぜつえいげき	空破絶影撃	名詞	TOS 没技
そうえんしょうがざん	蒼炎翔牙斬	名詞	TOS 没技
おそれなきちれい	恐れ無き地霊	名詞	TOS 没技
げつせんしょうこうは	月閃衝吼破	名詞	TOS 没技
げっせんしょうこうは	月閃衝吼破	名詞	TOS 没技
とうれつしゅう	踵裂蹴	名詞	TOS 没技
とうれっしゅう	踵裂蹴	名詞	TOS 没技
りゅうがれつこう	龍牙烈吼	名詞	TOS 没技
りゅうがれっこう	龍牙烈吼	名詞	TOS 没技
じゅうじんしょう	獣迅招	名詞	TOS 没技
ぜつひょうじん	絶氷刃	名詞	
ぜっひょうじん	絶氷刃	名詞	
れつはしょう	裂破衝	名詞	ToR ヴェイグが使用
れっぱしょう	裂破衝	名詞	ToR ヴェイグが使用
しゅんれんじん	瞬連塵	名詞	ToR ヴェイグが使用
ぜつしょうざん	絶翔斬	名詞	
ぜっしょうざん	絶翔斬	名詞	
げんりゅうざん	幻龍斬	名詞	
ぜつむひょうそう	絶・霧氷装	名詞	
ぜつ・むひょうそう	絶・霧氷装	名詞	
むひょうそう	霧氷装	名詞	
むえいしょう	無影衝	名詞	ToR ヴェイグが使用
ぜつしゅんえいじん	絶・瞬影迅	名詞	
ぜつ・しゅんえいじん	絶・瞬影迅	名詞	
しゅんえいじん	瞬影迅	名詞	
れんじんれつひょうげき	連塵裂氷撃	名詞	
れんじんれっひょうげき	連塵裂氷撃	名詞	
れんじんざんしょうけん	連塵斬翔剣	名詞	
れんじんりゅうえいじん	連塵龍影刃	名詞	
とうがしょうれつは	凍牙衝裂破	名詞	
とうがしょうれっぱ	凍牙衝裂破	名詞	
とうがりゅうえいじん	凍牙龍影刃	名詞	
とうがむえいけん	凍牙無影剣	名詞	
ぜつくうれつひょうげき	絶空裂氷撃	名詞	
ぜっくうれっひょうげき	絶空裂氷撃	名詞	
ぜつくうしょうれつは	絶空衝裂破	名詞	
ぜっくうしょうれつは	絶空衝裂破	名詞	
ぜっくうしょうれっぱ	絶空衝裂破	名詞	
ぜつくうりゅうえいじん	絶空龍影刃	名詞	
ぜっくうりゅうえいじん	絶空龍影刃	名詞	
げんまれんがしょう	幻魔連牙衝	名詞	
げんましょうれつは	幻魔衝裂破	名詞	
げんましょうれっぱ	幻魔衝裂破	名詞	
げんまざんしょうけん	幻魔斬翔剣	名詞	
しょうはれんがしょう	衝破連牙衝	名詞	
ほうりゅうしょうれつは	崩龍衝裂破	名詞	
ほうりゅうしょうれっぱ	崩龍衝裂破	名詞	
ほうりゅうむえいけん	崩龍無影剣	名詞	
せんぷうそう	旋風槍	名詞	
れつくそう	裂駆槍	名詞	
れっくそう	裂駆槍	名詞	
ごうはそう	轟破槍	名詞	
しゅんじんそう	瞬迅槍	名詞	ToR ユージーン、TOA ジェイド、ToI-R リカルドが使用
てんらいそう	天雷槍	名詞	
めつしょうそう	滅翔槍	名詞	
めっしょうそう	滅翔槍	名詞	
れんこうたいそう	錬・鋼体装	名詞	
れん・こうたいそう	錬・鋼体装	名詞	
こうたいそう	鋼体装	名詞	
れんきょうめいだん	錬・鏡銘弾	名詞	
れん・きょうめいだん	錬・鏡銘弾	名詞	
きょうめいだん	鏡銘弾	名詞	
れつふうじんそうしょう	裂風迅槍衝	名詞	
れっぷうじんそうしょう	裂風迅槍衝	名詞	
れつふうしゅんじんさつ	裂風瞬迅殺	名詞	
れっぷうしゅんじんさつ	裂風瞬迅殺	名詞	
れつふうばくらいじん	裂風爆雷陣	名詞	
れっぷうばくらいじん	裂風爆雷陣	名詞	
ごうばくせんぷうが	轟爆旋風牙	名詞	
ごうばくじんそうしょう	轟爆迅槍衝	名詞	
ごうばくてんしょうげき	轟爆天翔撃	名詞	
れつそうばくらいじん	裂走爆雷陣	名詞	
れっそうばくらいじん	裂走爆雷陣	名詞	
れつそうてんしょうげき	裂走天翔撃	名詞	
れっそうてんしょうげき	裂走天翔撃	名詞	
めつさつせんぷうが	滅殺旋風牙	名詞	
めっさつせんぷうが	滅殺旋風牙	名詞	
しゅんさつじんそうしょう	瞬殺迅槍衝	名詞	
しゅんさつごうしょうげき	瞬殺轟衝撃	名詞	
しゅんさつてんしょうげき	瞬殺天翔撃	名詞	
じんらいごうしょうげき	迅雷轟衝撃	名詞	
じんらいしゅんじんさつ	迅雷瞬迅殺	名詞	
じんらいてんしょうげき	迅雷天翔撃	名詞	
しょうれんきゃく	翔連脚	名詞	
ごうれつは	轟裂破	名詞	
ごうれっぱ	轟裂破	名詞	
がれんげき	牙連撃	名詞	
じゅほうせん	樹砲閃	名詞	
しっくうは	疾空波	名詞	
せんしょうせん	扇翔閃	名詞	
げきじゅそうへき	激・樹装壁	名詞	
げき・じゅそうへき	激・樹装壁	名詞	
じゅそうへき	樹装壁	名詞	
げきしゅんさつれん	激・瞬殺連	名詞	
げき・しゅんさつれん	激・瞬殺連	名詞	
しゅんさつれん	瞬殺連	名詞	
ひれんごうしょうが	飛連轟衝牙	名詞	
ひれんついれんせん	飛連墜蓮閃	名詞	
ひれんざんくうきゃく	飛連斬空脚	名詞	
ぐれんれんてんきゃく	愚連連天脚	名詞	
ぐれんついれんせん	愚連墜蓮閃	名詞	
ぐれんざんくうきゃく	愚連斬空脚	名詞	
ぐれんそうしょうせん	愚連蒼翔閃	名詞	
そうはれんてんきゃく	蒼破連天脚	名詞	
そうはついれんせん	蒼破墜蓮閃	名詞	
くうはついれんせん	空破墜蓮閃	名詞	
くうはそうしょうせん	空破蒼翔閃	名詞	
ごうれつれんがだん	轟裂連牙弾	名詞	
ごうれつざんくうきゃく	轟裂斬空脚	名詞	
ごうれつそうしょうせん	轟裂蒼翔閃	名詞	
ひおうごうしょうが	緋桜轟衝牙	名詞	
ぐれんてんしょう	紅蓮天翔	名詞	
ふれいむえんちゃんと	F・エンチャント	名詞	
ふれいむ・えんちゃんと	F・エンチャント	名詞	
ふれいむえんちゃんと	フレイム・エンチャント	名詞	
ふれいむ・えんちゃんと	フレイム・エンチャント	名詞	
ふぉるすふれいむ	F・フレイム	名詞	
ふぉるす・ふれいむ	F・フレイム	名詞	
ふぉるすふれいむ	フォルス・フレイム	名詞	
ふぉるす・ふれいむ	フォルス・フレイム	名詞	
どらっぐれーべん	D・レーベン	名詞	
どらっぐ・れーべん	D・レーベン	名詞	
どらっぐれーべん	ドラッグ・レーベン	名詞	
どらっぐ・れーべん	ドラッグ・レーベン	名詞	
らいずえりきしる	R・エリキシル	名詞	
らいず・えりきしる	R・エリキシル	名詞	
らいずえりきしる	ライズ・エリキシル	名詞	
らいず・えりきしる	ライズ・エリキシル	名詞	
ぱわーくらふと	パワー・クラフト	名詞	
ぱわー・くらふと	パワー・クラフト	名詞	
まいんどがいすと	マインド・ガイスト	名詞	
まいんど・がいすと	マインド・ガイスト	名詞	
がーどう゛ぁっさー	ガード・ヴァッサー	名詞	
がーど・う゛ぁっさー	ガード・ヴァッサー	名詞	
がーどゔぁっさー	ガード・ヴァッサー	名詞	
がーど・ゔぁっさー	ガード・ヴァッサー	名詞	
れじすとう゛ぃれ	レジスト・ヴィレ	名詞	
れじすと・う゛ぃれ	レジスト・ヴィレ	名詞	
れじすとゔぃれ	レジスト・ヴィレ	名詞	
れじすと・ゔぃれ	レジスト・ヴィレ	名詞	
らいふまてりあ	ライフ・マテリア	名詞	
らいふ・まてりあ	ライフ・マテリア	名詞	
ちゃーじう゛ぃんと	チャージ・ヴィント	名詞	
ちゃーじ・う゛ぃんと	チャージ・ヴィント	名詞	
ちゃーじゔぃんと	チャージ・ヴィント	名詞	
ちゃーじ・ゔぃんと	チャージ・ヴィント	名詞	
れでゅーすれーげん	レデュース・レーゲン	名詞	
れでゅーす・れーげん	レデュース・レーゲン	名詞	
あーつれーげん	アーツ・レーゲン	名詞	
あーつ・れーげん	アーツ・レーゲン	名詞	
ぺいんれーげん	ペイン・レーゲン	名詞	
ぺいん・れーげん	ペイン・レーゲン	名詞	
しぇいぶれーげん	シェイブ・レーゲン	名詞	
しぇいぶ・れーげん	シェイブ・レーゲン	名詞	
ばーすとれーげん	バースト・レーゲン	名詞	
ばーすと・れーげん	バースト・レーゲン	名詞	
すたんれーげん	スタン・レーゲン	名詞	
すたん・れーげん	スタン・レーゲン	名詞	
ふらっしゅれーげん	フラッシュ・レーゲン	名詞	
ふらっしゅ・れーげん	フラッシュ・レーゲン	名詞	
ふぁすとれーげん	ファスト・レーゲン	名詞	
ふぁすと・れーげん	ファスト・レーゲン	名詞	
ぶれいくれーげん	ブレイク・レーゲン	名詞	
ぶれいく・れーげん	ブレイク・レーゲン	名詞	
がんびっとれーげん	ガンビット・レーゲン	名詞	
がんびっと・れーげん	ガンビット・レーゲン	名詞	
ぶらすとれーげん	ブラスト・レーゲン	名詞	
ぶらすと・れーげん	ブラスト・レーゲン	名詞	
ひーるれーげん	ヒール・レーゲン	名詞	
ひーる・れーげん	ヒール・レーゲン	名詞	
らいとにんぐろーぶ	L・ローブ	名詞	
らいとにんぐ・ろーぶ	L・ローブ	名詞	
らいとにんぐろーぶ	ライトニング・ローブ	名詞	
らいとにんぐ・ろーぶ	ライトニング・ローブ	名詞	
りみてっどそーさりー	L・ソーサリー	名詞	
りみてっど・そーさりー	L・ソーサリー	名詞	
りみてっどそーさりー	リミテッド・ソーサリー	名詞	
りみてっど・そーさりー	リミテッド・ソーサリー	名詞	
いんふぃにてぃあすとらいく	インフィニティア・ストライク	名詞	
いんふぃにてぃあ・すとらいく	インフィニティア・ストライク	名詞	
せるしうすきゃりばー	セルシウス・キャリバー	名詞	ToR秘奥義
せるしうす・きゃりばー	セルシウス・キャリバー	名詞	ToR秘奥義
ぷりずみっくすたーず	プリズミック・スターズ	名詞	ToR秘奥義
ぷりずみっく・すたーず	プリズミック・スターズ	名詞	ToR秘奥義
しゅたいふぇぶりーぜ	シュタイフェ・ブリーゼ	名詞	
しゅたいふぇ・ぶりーぜ	シュタイフェ・ブリーゼ	名詞	
ふぁいでりてぃてすためんと	ファイデリティ・テスタメント	名詞	
ふぁいでりてぃ・てすためんと	ファイデリティ・テスタメント	名詞	
せべらてぃおーばーろーど	セベラティ・オーバーロード	名詞	
せべらてぃ・おーばーろーど	セベラティ・オーバーロード	名詞	
すぷれっどぶるー	スプレッド・ブルー	名詞	
すぷれっど・ぶるー	スプレッド・ブルー	名詞	
あくえりあすすふぃあ	アクエリアス・スフィア	名詞	
あくえりあす・すふぃあ	アクエリアス・スフィア	名詞	
しぇいどむーんれべりおん	シェイドムーン・レベリオン	名詞	
しぇいどむーん・れべりおん	シェイドムーン・レベリオン	名詞	
まじんけん	魔神拳	名詞	TOL セネル、TOA ルーク、TOA アッシュが使用
げんりゅうけん	幻竜拳	名詞	
はくげきしょう	迫撃掌	名詞	
ふんりゅうげき	噴竜撃	名詞	
ようそうきゃく	鷹爪脚	名詞	
ろんどせんぷう	輪舞旋風	名詞	
がりゅうさい	臥竜砕	名詞	
ばくりゅうけん	爆竜拳	名詞	TOL セネル、ToI エルマーナが使用
ばくがだん	爆牙弾	名詞	
まじんけんそうが	魔神拳・双牙	名詞	TOL セネルが使用
まじんけん・そうが	魔神拳・双牙	名詞	TOL セネルが使用
まじんげんりゅうけん	魔神幻竜拳	名詞	
ばくげきしょう	爆撃掌	名詞	
しんりゅうげき	神竜撃	名詞	
じんりゅうげき	神竜撃	名詞	
はくげきごうしょうらい	迫撃剛招来	名詞	
ひれんげんりゅうけん	飛連幻竜拳	名詞	
れんがひえんきゃく	連牙飛燕脚	名詞	
ろんどふんりゅうれんげき	輪舞噴竜連撃	名詞	
まじんけんりゅうが	魔神拳・竜牙	名詞	
まじんけん・りゅうが	魔神拳・竜牙	名詞	
りゅうが	竜牙	名詞	
さいがばくりゅうけん	砕臥爆竜拳	名詞	TOL セネルが使用
はくげきせんこう	迫撃戦吼	名詞	
ろんどばくがだん	輪舞爆牙弾	名詞	
りゅうおうてんく	竜凰天駆	名詞	TOL セネルが使用
けいがんさいらくげき	軽岩砕落撃	名詞	
れんがんほうらくげき	煉岩崩落撃	名詞	
れきがんはくらくげき	礫岩迫落撃	名詞	
きょがんれつらくげき	巨岩裂落撃	名詞	
がくがんぜつらくげき	嶽岩絶落撃	名詞	
ばんぶつしんついげき	万物神追撃	名詞	
ばんのうちょうぜつなげ	万能超絶投げ	名詞	TOL セネル 没技
とうまめいついげき	筒魔冥追撃	名詞	
きょうきらくついげき	凶鬼落追撃	名詞	
ぎょりんさくついげき	魚鱗削追撃	名詞	
ようがほうついげき	妖臥崩追撃	名詞	
おうじゃこうついげき	翁蛇絞追撃	名詞	
そんのうごくついげき	尊王獄追撃	名詞	
そんおうごくついげき	尊王獄追撃	名詞	
はおうじんついげき	覇王迅追撃	名詞	
ぐうきさんついげき	偶機散追撃	名詞	
もうかいせんついげき	猛海閃追撃	名詞	
むじんけいついげき	霧神禊追撃	名詞	
じ・えんど	ジ・エンド	名詞	
じえんど	ジ・エンド	名詞	
しっぷうせん	疾風閃	名詞	
くうれつざん	空裂斬	名詞	
しょうぶ	昇舞	名詞	
けんぶ	絢舞	名詞	
げつえいじん	月影刃	名詞	
げんしょうけん	幻晶剣	名詞	
じんう	迅羽	名詞	
じんぷうせん	神風閃	名詞	
しゅううまじんけん	驟雨魔神剣	名詞	
しゅううこがはざん	驟雨虎牙破斬	名詞	
こがくうれつざん	虎牙空裂斬	名詞	
まじんけんけんぶ	魔神剣・絢舞	名詞	
まじんけん・けんぶ	魔神剣・絢舞	名詞	
げつえいしょうぶ	月影昇舞	名詞	
しゅううげんしょうけん	驟雨幻晶剣	名詞	
じんうくうれつざん	迅羽空裂斬	名詞	
きりさざめ	霧沙雨	名詞	
しょうぶじんぷうせん	昇舞神風閃	名詞	
まじんけんしゅんが	魔神剣・瞬牙	名詞	
まじんけん・しゅんが	魔神剣・瞬牙	名詞	
しゅんが	瞬牙	名詞	
しでんげつえいじん	紫電月影刃	名詞	
りんじんせんようげき	鱗人閃邀撃	名詞	
きょうひれつようげき	凶羆裂邀撃	名詞	
きょうひ	凶羆裂邀撃	名詞	キョウヒレツヨウゲキ
がろうぶようげき	餓狼舞邀撃	名詞	
がろう	餓狼舞邀撃	名詞	ガロウブヨウゲキ
ようけんえいようげき	妖剣影邀撃	名詞	
ききじんようげき	鬼亀迅邀撃	名詞	
せっきふうようげき	石姫風邀撃	名詞	
せききふうようげき	石姫風邀撃	名詞	セッキフウヨウゲキ
いしひめふうようげき	石姫風邀撃	名詞	セッキフウヨウゲキ
せきひめふうようげき	石姫風邀撃	名詞	セッキフウヨウゲキ
いしひめ	石姫風邀撃	名詞	セッキフウヨウゲキ
ろうは	狼破	名詞	
わしゅう	鷲羽	名詞	
せんこう	穿孔	名詞	TOL モーゼスが使用
こしん	孤心	名詞	
れんぱ	連破	名詞	
れんは	連破	名詞	
らんじん	嵐陣	名詞	
れつくう	烈空	名詞	
れっくう	烈空	名詞	
こほう	虎砲	名詞	
ろうう	狼羽	名詞	
せんこうろうは	穿孔狼破	名詞	
かいしん	戒心	名詞	
せんこうらんじんしゃ	穿孔嵐陣射	名詞	
れってん	裂天	名詞	
れつてん	裂天	名詞	
こしんれつくうしゃ	弧心烈空射	名詞	
こしんれっくうしゃ	弧心烈空射	名詞	
ろうおうは	狼王破	名詞	
じゅつしりゅうもうしゃ	術士龍猛射	名詞	
かいちょうよくもうしゃ	怪鳥翼猛射	名詞	
どうじょうせんもうしゃ	動茸穿猛射	名詞	
どうきのこせんもうしゃ	動茸穿猛射	名詞	ドウジョウセンモウシャ
げんかいらんもうしゃ	源塊嵐猛射	名詞	
きらんおうもうしゃ	奇卵凰猛射	名詞	
よくびょうれつもうしゃ	翼猫烈猛射	名詞	
よくねこれつもうしゃ	翼猫烈猛射	名詞	ヨクビョウレツモウシャ
めいかい	命戒	名詞	
くない	苦無	名詞	
ほむら	焔	名詞	
ひょうじゅ	氷樹	名詞	
きょうさつ	鏡殺	名詞	
あんそうは	闇走破	名詞	
どらん	土乱	名詞	
かげぬい	影縫い	名詞	TOL ジェイが使用
うきぐも	浮雲	名詞	
ふうが	風雅	名詞	
しょうよく	翔翼	名詞	
りんめい	鈴鳴	名詞	
くないほむら	苦無・焔	名詞	
くない・ほむら	苦無・焔	名詞	
おぼろひょうじゅ	朧氷樹	名詞	
あんそうほむら	闇走焔	名詞	
おぼろどらん	朧土乱	名詞	
あんそうらいでん	闇走雷電	名詞	
かげそうは	影走破	名詞	
うきぐもふうが	浮雲・風雅	名詞	
りんめいくない	鈴鳴苦無	名詞	
ぎしんらくさつげき	偽神落殺劇	名詞	
ちょうちゅうふんさつげき	跳蟲噴殺劇	名詞	
げんえいそうさつげき	幻影走殺劇	名詞	
ちしゅしゅうさつげき	蜘蛛蹴殺劇	名詞	
くもしゅうさつげき	蜘蛛蹴殺劇	名詞	チシュシュウサツゲキ
ちしゅ	蜘蛛蹴殺劇	名詞	チシュシュウサツゲキ
ようじゅんばくさつげき	妖盾爆殺劇	名詞	
まじんふうさつげき	魔神封殺劇	名詞	
どくのこな	毒の粉	名詞	
せきかこな	石化粉	名詞	
いかりこな	怒り粉	名詞	
くるいこな	狂い粉	名詞	
いやしこな	癒し粉	名詞	
しびれこな	しびれ粉	名詞	
せきかごな	石化粉	名詞	
いかりごな	怒り粉	名詞	
くるいごな	狂い粉	名詞	
いやしごな	癒し粉	名詞	
しびれごな	しびれ粉	名詞	
りゅうせいあたっく	流星アタック	名詞	
しんだふり	死んだふり	名詞	
かえんほうしゃ	火炎放射	名詞	
へっぴりといき	へっぴり吐息	名詞	
さいごっぺ	最後っ屁	名詞	
すいとり	吸い取り	名詞	
ほういもう	包囲網	名詞	
ちょうやくれんげき	跳躍連撃	名詞	
とっしん	突進	名詞	
すてみのいちげき	すてみの一撃	名詞	
やつざきらんぶ	やつざき乱舞	名詞	
せつまのたち	刹那の太刀	名詞	
てんとう	転倒	名詞	
とうごく	投獄	名詞	
おうだ	殴打	名詞	
れんぞくぎり	連続斬り	名詞	
とかげらんぶ	トカゲ乱舞	名詞	
せっきのひとみ	石姫の瞳	名詞	
せききのひとみ	石姫の瞳	名詞	
いしひめのひとみ	石姫の瞳	名詞	
せっきのしせん	石姫の視線	名詞	
せききのしせん	石姫の視線	名詞	
いしひめのしせん	石姫の視線	名詞	
いえいえおさきにどうぞ	いえいえお先にどうぞ	名詞	
しゅうかえき	消化液	名詞	
かいすいふんしゃ	海水噴射	名詞	
かいすいだいふんしゃ	海水大噴射	名詞	
はおうのてっつい	覇王の鉄槌	名詞	
はおうのほうだん	覇王の砲弾	名詞	
はおうのめいどう	覇王の鳴動	名詞	
しんそくのきば	神速の牙	名詞	
うんかのきば	雲霞の牙	名詞	
くもかすみのきば	雲霞の牙	名詞	
くもがすみのきば	雲霞の牙	名詞	
にくさき	肉裂き	名詞	
ほねくだき	骨砕き	名詞	
ごぞうくずし	五臓崩し	名詞	
たましいやぶりのまい	魂破りの舞い	名詞	
にくさきかい	肉裂き・改	名詞	
ほねくだきかい	骨砕き・改	名詞	
ごぞうくずしかい	五臓崩し・改	名詞	
たましいやぶりのまいかい	魂破りの舞い・改	名詞	
にくさき・かい	肉裂き・改	名詞	
ほねくだき・かい	骨砕き・改	名詞	
ごぞうくずし・かい	五臓崩し・改	名詞	
たましいやぶりのまい・かい	魂破りの舞い・改	名詞	
ぱんさざめ	パン沙雨	名詞	
まじんぱん	魔神パン	名詞	
しょうぱん	昇パン	名詞	
けんぱん	絢パン	名詞	
まじんぱんけんぱん	魔神パン・絢パン	名詞	
まじんぱん・けんぱん	魔神パン・絢パン	名詞	
ぱんはざん	パン破斬	名詞	
げんしょうぱん	幻晶パン	名詞	
しょうぱんじんぷうせん	昇パン神風閃	名詞	
しでんぱんえいじん	紫電パン影刃	名詞	
ぱんようげき	パン邀撃	名詞	
こうか	紅華	名詞	
ひゃっかりょうらん	百花繚乱	名詞	
ざんしゅえんじん	斬首円刃	名詞	
しりょうえんぶ	死霊円舞	名詞	
かいたいさぎょうそのいち	解体作業その1	名詞	
かいたいさぎょうそのに	解体作業その2	名詞	
かいたいさぎょうその1	解体作業その1	名詞	
かいたいさぎょうその2	解体作業その2	名詞	
ごうれいざん	轟霊斬	名詞	
かいれつざん	界烈斬	名詞	
いちのかまえ	壱の構え	名詞	
いちのかまえ	壱の構え 立待	名詞	
いちのかまえたちまち	壱の構え 立待	名詞	
たちまち	立待	名詞	
にのかまえ	弐の構え	名詞	
にのかまえ	弐の構え 居待	名詞	
にのかまえいまち	弐の構え 居待	名詞	
いまち	居待	名詞	
さんのかまえ	惨の構え	名詞	
さんのかまえ	惨の構え 臥待	名詞	
さんのかまえふしまち	惨の構え 臥待	名詞	
ふしまち	臥待	名詞	
しのかまえ	死の構え	名詞	
しのかまえ	死の構え 更待	名詞	
しのかまえふけまち	死の構え 更待	名詞	
ふけまち	更待	名詞	
ばくさいげき	爆砕撃	名詞	
めいかいしょう	冥界掌	名詞	
まおうけん	魔王拳	名詞	
とうじんりきばくとう	闘神力爆投	名詞	
はおうばくさいげき	覇王爆砕撃	名詞	
ぶていれんさつけん	武帝煉殺拳	名詞	
とうじんめいかいしょう	闘神冥界掌	名詞	
ふぇるくぇすてす	滄翼天翔	名詞	
そうよくてんしょう	滄翼天翔	名詞	
ふぇすくぇん	水鳥の飛翔	名詞	
みずどりのひしょう	水鳥の飛翔	名詞	
でるくぇす	破壊の翼	名詞	
はかいのつばさ	破壊の翼	名詞	
せるでるくぇす	殺戮の翼	名詞	
さつりくのつばさ	殺戮の翼	名詞	
すいじんせんこう	水神戦吼	名詞	
すいしょうごく	水翔獄	名詞	
そうしょうごく	滄翔獄	名詞	
うみのあぎと	海の顎門	名詞	
たけりのそうが	猛りの滄我	名詞	
もうかいのなみ	猛海の波	名詞	
もうかいのゆみ	猛海の弓	名詞	
もうかいのやり	猛海の槍	名詞	
もうかいのむち	猛海の鞭	名詞	
もうかいのつち	猛海の鎚	名詞	
もうかいのいかり	猛海の怒り	名詞	
もうかいのしゃりん	猛海の車輪	名詞	
もうかいのだいじゃ	猛海の大蛇	名詞	
しょうおん	鐘音	名詞	
やみほたる	闇蛍	名詞	
あんけい	闇蛍	名詞	
きょうりょくやみほたる	強力闇蛍	名詞	
きょうりょくあんけい	強力闇蛍	名詞	
えんごく	焔獄	名詞	
まじんれんげき	魔神連撃	名詞	
まじんらんげき	魔神乱撃	名詞	
しんまじんけん	真・魔神拳	名詞	
しん・まじんけん	真・魔神拳	名詞	
しんまじんれつふう	真・魔神烈風	名詞	
しんまじんれっぷう	真・魔神烈風	名詞	
しん・まじんれつふう	真・魔神烈風	名詞	
しん・まじんれっぷう	真・魔神烈風	名詞	
まじんれつふう	魔神烈風	名詞	
まじんれつぷう	魔神烈風	名詞	
まじんれっぷう	魔神烈風	名詞	
まじんきえんだん	魔神気焔弾	名詞	
いのちのせんりつ	命の旋律	名詞	
いのちのらせん	命の螺旋	名詞	
きょじのどくそうきょく	虚時の独奏曲	名詞	
どくまじん	毒魔陣	名詞	
まひまじん	麻痺魔陣	名詞	
せきかまじん	石化魔陣	名詞	
とうけつまじん	凍結魔陣	名詞	
そくばくまじん	束縛魔陣	名詞	
きょうこうまじん	恐慌魔陣	名詞	
えんじょうまじん	炎上魔陣	名詞	
そうじゅつふういんまじん	爪術封印魔陣	名詞	
どろどろまじん	ドロドロ魔陣	名詞	
こうげきていかまじん	攻撃低下魔陣	名詞	
ぼうぎょていかまじん	防御低下魔陣	名詞	
ちせいていかまじん	知性低下魔陣	名詞	
めいちゅうていかまじん	命中低下魔陣	名詞	
いどうそくどていかまじん	移動速度低下魔陣	名詞	
えいしょうそくどていかまじん	詠唱速度低下魔陣	名詞	
ひたいせいていかまじん	火耐性低下魔陣	名詞	
うみたいせいていかまじん	海耐性低下魔陣	名詞	
こおりたいせいていかまじん	氷耐性低下魔陣	名詞	
ほうしゅうきゃく	崩襲脚	名詞	TOA ルーク、TOA アッシュ、TOH-R ガラドが使用
ぐれんしゅうげき	紅蓮襲撃	名詞	
せんしょうは	穿衝破	名詞	
えいしょうらい	鋭招来	名詞	
れつはしょう	烈破掌	名詞	TOA勢、ToV ユーリ、TOX ジュードが使用
れっぱしょう	烈破掌	名詞	TOA勢、ToV ユーリ、TOX ジュードが使用
ぜつはれつひょうげき	絶破烈氷撃	名詞	
ぜっぱれっひょうげき	絶破烈氷撃	名詞	
ぜっぱれつひょうげき	絶破烈氷撃	名詞	
しゅごひょうそうじん	守護氷槍陣	名詞	
まおうぜつえんこう	魔王絶炎煌	名詞	
まおうちがくじん	魔王地顎陣	名詞	
ひえんしゅんれんざん	飛燕瞬連斬	名詞	
ざんまひえいざん	斬魔飛影斬	名詞	
がれんほうしゅうがく	牙連崩襲顎	名詞	
ざんえいれつこうし	斬影烈昴刺	名詞	ゲーム中の表記
ざんえいれっこうし	斬影烈昴刺	名詞	ゲーム中の表記
ざんえいれつぼうし	斬影烈昴刺	名詞	ゲーム中の表記
ざんえいれつこうし	斬影烈昂刺	名詞	
ざんえいれっこうし	斬影烈昂刺	名詞	
つうがれんはざん	通牙連破斬	名詞	
せんはざんげつしゅう	穿破斬月襲	名詞	
せんぱざんげつしゅう	穿破斬月襲	名詞	
せんはざんげっしゅう	穿破斬月襲	名詞	
せんぱざんげっしゅう	穿破斬月襲	名詞	
ようそうごうしょうは	鷹爪豪掌破	名詞	
れつせんそうげきは	烈穿双撃破	名詞	
れっせんそうげきは	烈穿双撃破	名詞	
れいでぃあんとはうる	レイディアント・ハウル	名詞	
れいでぃあんと・はうる	レイディアント・ハウル	名詞	
ろすとふぉんどらいぶ	ロスト・フォン・ドライブ	名詞	
ろすと・ふぉん・どらいぶ	ロスト・フォン・ドライブ	名詞	
いおんしょうかん	イオン召喚	名詞	
こうがめいしょうざん	絞牙鳴衝斬	名詞	
すぺるえんはんす	スペル・エンハンス	名詞	
すぺる・えんはんす	スペル・エンハンス	名詞	
せう゛ぁーどふぇいと	セヴァードフェイト	名詞	TOA ティアが使用
せゔぁーどふぇいと	セヴァードフェイト	名詞	TOA ティアが使用
せう゛ぁーとふぇいと	セヴァードフェイト	名詞	TOA ティアが使用
せゔぁーとふぇいと	セヴァードフェイト	名詞	TOA ティアが使用
せう゛ぁーどふぇいと	セヴェードフェイト	名詞	TOX ローエンが使用
せゔぁーどふぇいと	セヴェードフェイト	名詞	TOX ローエンが使用
いのせんとしゃいん	イノセント・シャイン	名詞	
いのせんと・しゃいん	イノセント・シャイン	名詞	
ふぉーちゅーんあーく	フォーチューン・アーク	名詞	
ふぉーちゅーん・あーく	フォーチューン・アーク	名詞	
だいふか	大譜歌	名詞	
らいじんせんぷうそう	雷神旋風槍	名詞	
がんさいれつじんそう	岩砕烈迅槍	名詞	
てんしょうついがそう	天衝墜牙槍	名詞	
ついがばくえんそう	墜牙爆炎槍	名詞	
ふうじんこうせんしょう	風塵皇旋衝	名詞	
すいじんかりゅうそう	水塵渦龍槍	名詞	
どれいんまじっく	ドレイン・マジック	名詞	
どれいん・まじっく	ドレイン・マジック	名詞	
みすてぃっくけーじ	ミスティック・ケージ	名詞	
みすてぃっく・けーじ	ミスティック・ケージ	名詞	
がりょうげき	臥龍撃	名詞	
ようそうしゅうげき	鷹爪襲撃	名詞	TOA アニス、ToG ソフィ、なりダンX メルが使用
こうりゅうれきは	昴龍礫破	名詞	ゲーム中の表記
こうりゅうれっぱ	昴龍礫破	名詞	ゲーム中の表記
ぼうりゅうれきは	昴龍礫破	名詞	ゲーム中の表記
ぼうりゅうれっぱ	昴龍礫破	名詞	ゲーム中の表記
こうりゅうれきは	昂龍礫破	名詞	
こうりゅうれっぱ	昂龍礫破	名詞	
そうせんが	双旋牙	名詞	
らいせんごうてんが	雷旋豪転牙	名詞	
りゅうえいだ	流影打	名詞	
かりゅうしょうは	火龍焼破	名詞	
ひょうそうしゅうらく	氷爪襲落	名詞	
しょうぶこうばくは	翔舞煌爆破	名詞	
しょうぶこうばっぱ	翔舞煌爆破	名詞	
りゅうぶほうばくは	流舞崩瀑波	名詞	TOA アニスが使用
りゅうぶほうばっぱ	流舞崩瀑波	名詞	TOA アニスが使用
くうはばくえんだん	空破爆炎弾	名詞	
れんとうらいこうだん	連濤雷光弾	名詞	
そうれんりゅうがしょう	爪連龍牙昇	名詞	
そうりゅうれつとうだ	爪竜烈濤打	名詞	
そうりゅうれっとうだ	爪竜烈濤打	名詞	
ざんえいれんせんげき	斬影連旋撃	名詞	
ごうしょうは	剛掌破	名詞	
ちょうぱちき	超ぱちき	名詞	
えっくすばすたー	Xバスター	名詞	
xばすたー	Xバスター	名詞	
いざよいてんぶ	十六夜天舞	名詞	
こげつせん	弧月閃	名詞	TOA ガイ、TOT フォレスト、ToI ルカ、マイソロ2 プレセアが使用
りゅうそうせんくうは	龍爪旋空破	名詞	
れつしんせんしょうは	烈震千衝破	名詞	
れっしんせんしょうは	烈震千衝破	名詞	
ぜつはじゅうじしょう	絶破十字衝	名詞	
ぜっぱじゅうじしょう	絶破十字衝	名詞	
ぜつしょうひょうがじん	絶衝氷牙陣	名詞	
ぜっしょうひょうがじん	絶衝氷牙陣	名詞	
まじんげつえいか	魔神月詠華	名詞	
ぜつくうまじんげき	絶空魔神撃	名詞	
ぜっくうまじんげき	絶空魔神撃	名詞	
げつかざんこうせん	月華斬光閃	名詞	
げっかざんこうせん	月華斬光閃	名詞	
びゃっこしょうせんが	白虎宵閃牙	名詞	
こくうれんしょうじん	虚空連衝刃	名詞	
ほうおうてんしょうく	鳳凰天翔駆	名詞	
せんぱしゅんれんじん	閃覇瞬連刃	名詞	
せんはしゅんれんじん	閃覇瞬連刃	名詞	
あすとらるれいん	アストラル・レイン	名詞	
あすとらる・れいん	アストラル・レイン	名詞	
のーぶるろあー	ノーブル・ロアー	名詞	
のーぶる・ろあー	ノーブル・ロアー	名詞	
あかしっくとーめんと	アカシック・トーメント	名詞	
あかしっく・とーめんと	アカシック・トーメント	名詞	
しっぷうらいせんぶ	疾風雷閃舞	名詞	
かりゅうそう	火竜爪	名詞	
しこうらいがせん	紫光雷牙閃	名詞	
ちりゅうこうは	地龍吼破	名詞	
えんがばくさいこう	炎牙爆砕吼	名詞	
れっかしょうせん	烈火衝閃	名詞	
ぐれんせんしょうらん	紅蓮旋衝嵐	名詞	
こうりゅうそう	光龍槍	名詞	TOA ヴァンが使用
こうりゅうそう・かい	光龍槍・改	名詞	
こうりゅうそうかい	光龍槍・改	名詞	
せんくうけん	閃空剣	名詞	TOA ヴァンが使用
せいおうそうはじん	星皇蒼破陣	名詞	
しんそうせいじょうは	神葬星条破	名詞	
えんしぇんとれくいえむ	エンシェント・レクイエム	名詞	
えんしぇんと・れくいえむ	エンシェント・レクイエム	名詞	
えんど・おぶ・ふらぐめんと	エンド・オブ・フラグメント	名詞	
えんどおぶふらぐめんと	エンド・オブ・フラグメント	名詞	
こげつざん	弧月斬	名詞	
てんちもうそうげき	天地猛爪撃	名詞	
こくうれつざん	虚空裂斬	名詞	
しぐれさんか	時雨散花	名詞	
しぐれざんか	時雨散花	名詞	
てんしょうれんがげき	天翔連牙撃	名詞	
じゅうじんか	獣人化	名詞	
こずみっくれい	コズミック・レイ	名詞	
こずみっく・れい	コズミック・レイ	名詞	
だすととれいる	ダスト・トレイル	名詞	
だすと・とれいる	ダスト・トレイル	名詞	
げつさいだ	月砕打	名詞	
げっさいだ	月砕打	名詞	
ごうせんばくさいだ	豪旋爆砕打	名詞	
とうじょらいじんけん	闘女らいじんけん	名詞	
とうじょらいじんけん	闘女雷神拳	名詞	
ちょうぱんさざめ	超・パン沙雨	名詞	
ちょう・ぱんさざめ	超・パン沙雨	名詞	
れつくうじん	裂空刃	名詞	ToI-R スパーダ、ToG アスベル、なりダン2 なりダン3 ウッドロウが使用
れっくうじん	裂空刃	名詞	ToI-R スパーダ、ToG アスベル、なりダン2 なりダン3 ウッドロウが使用
しょううれつくうげき	翔雨烈空撃	名詞	なりダン2 リッドが使用
しょううれっくうげき	翔雨烈空撃	名詞	なりダン2 リッドが使用
まおうえんげきは	魔王炎撃破	名詞	ToI ルカ、なりダン2 なりダン3 スタンが使用
きょうおうれんごくぶ	狂王鎌獄舞	名詞	
えたーなるふぁいなりてぃ	E・ファイナリティ	名詞	なりダン3 シゼルが使用
いんでぃぐねいとじゃっじめんと	I・ジャッジメント	名詞	なりダン3 エルレインが使用
いんでぃぐねいと・じゃっじめんと	I・ジャッジメント	名詞	なりダン3 エルレインが使用
れつせんは	裂旋破	名詞	
れっせんぱ	裂旋破	名詞	
ほうしょうしゅうげき	崩昇蹴撃	名詞	マイソロ戦士が使用
がせんしょうは	牙旋衝破	名詞	
がとつしょう	牙突衝	名詞	
ひしょうじん	飛翔刃	名詞	
くうしゅうじん	空襲刃	名詞	
がとつれんげき	牙突連撃	名詞	
ひしょうれんざん	飛翔連斬	名詞	
じゃこうがとつ	蛇咬牙突	名詞	
がれんじん	牙連刃	名詞	
しょうがれつが	翔牙裂臥	名詞	
ざんじんれんがとつ	斬刃連牙突	名詞	
ばくとつしゅうげき	爆突襲撃	名詞	
れんがひしょうこう	連牙飛翔鮫	名詞	
てんせいれんがとつ	転生蓮牙突	名詞	
ばくとつごうしょうげき	爆突轟衝撃	名詞	
がりゅうくうは	臥龍空破	名詞	
くないせん	苦無閃	名詞	
めつしょうは	滅掌破	名詞	
めっしょうは	滅掌破	名詞	
せんそうが	閃走牙	名詞	
ちれつざん	地裂斬	名詞	
どりゅうせん	土竜閃	名詞	
せつげつか	刹月華	名詞	
せつげっか	刹月華	名詞	
まんじゅしゃげ	曼樹沙華	名詞	マイソロ1、2忍者が使用
げんまれつしょう	幻魔裂衝	名詞	
げんまれっしょう	幻魔裂衝	名詞	
えいそうざん	影走斬	名詞	
きえんざん	鬼炎斬	名詞	
しんとうめっきゃく	心頭滅却	名詞	
きえんれんきゃく	鬼炎連脚	名詞	
ざんまめつさつけん	斬魔滅殺剣	名詞	
ざんまめっさつけん	斬魔滅殺剣	名詞	
ざんまりゅうえんけん	斬魔龍炎剣	名詞	
げんまれつざんえい	幻魔烈残影	名詞	
かしゃおとし	火車落とし	名詞	
ふうまくいんけん	封魔九印剣	名詞	
ふうまきゅういんけん	封魔九印剣	名詞	
ほうしゅうけん	崩襲剣	名詞	
ほうしょうしゅうざん	崩昇襲斬	名詞	
こげつそうせん	弧月双閃	名詞	
ようそうれつふうけん	鷹爪烈風剣	名詞	
ようそうれっぷうけん	鷹爪烈風剣	名詞	
ねつぱせんぷうじん	熱波旋風陣	名詞	ToI ルカが使用
ねっぱせんぷうじん	熱波旋風陣	名詞	ToI ルカが使用
れつふうげつかしょう	烈風月華衝	名詞	
れつふうげっかしょう	烈風月華衝	名詞	
れっぷうげつかしょう	烈風月華衝	名詞	
れっぷうげっかしょう	烈風月華衝	名詞	
しゅんじんしょう	瞬迅衝	名詞	
もうしゅうげき	猛襲撃	名詞	
ごうしょうはざん	轟衝破斬	名詞	
ほうしゅうしんしょう	崩襲震衝	名詞	
さいろうが	砕狼牙	名詞	
まじんけん・ほむら	魔神剣・焔	名詞	
まじんけんほむら	魔神剣・焔	名詞	
まじんけん・えん	魔神剣・焔	名詞	マジンケン・ホムラ
まじんけんえん	魔神剣・焔	名詞	マジンケン・ホムラ
れっかばくえんそう	烈火爆炎走	名詞	
れつかばくえんそう	烈火爆炎走	名詞	
まおうばくえんそう	魔王爆炎槍	名詞	
ひえんごうはざん	緋焔轟覇斬	名詞	
まおうしゃくめつじん	魔王灼滅刃	名詞	
あぶそりゅーと・ぜろ	アブソリュート・ゼロ	名詞	
あぶそりゅーとぜろ	アブソリュート・ゼロ	名詞	
るいんどべいんうぃっしゅ	ルインド・ベイン・ウィッシュ	名詞	
るいんどべいんうぃっしゅ	RVウィッシュ	名詞	
るいんど・べいん・うぃっしゅ	ルインド・ベイン・ウィッシュ	名詞	
るいんど・べいん・うぃっしゅ	RVウィッシュ	名詞	
しめつしょう	視滅衝	名詞	
ごうらいじん	轟雷刃	名詞	
せんしゅうざん	旋襲斬	名詞	
くうはついじん	空破追刃	名詞	
りゅうじんせん	流刃旋	名詞	
せつがしょう	刹牙衝	名詞	
じゅうそうざん	獣爪斬	名詞	
じんらいせん	迅雷閃	名詞	
ふうざんしょう	風斬衝	名詞	
かいせんじん	廻旋刃	名詞	
そうざんしょう	双斬翔	名詞	
じゅうそうしゅんじんが	獣爪瞬刃牙	名詞	
れっくうふうざんしょう	裂空風斬衝	名詞	
れつくうふうざんしょう	裂空風斬衝	名詞	
らいじんごうてんげき	雷神轟天撃	名詞	
じゅうおうらいじんけん	獣皇雷迅剣	名詞	
しんれつせんこうざん	神裂閃光斬	名詞	
こうはじん	光波刃	名詞	ToI アンジュが使用
がれんこうはじん	牙連光波刃	名詞	
せんこうしょう	閃光翔	名詞	ToI-R アンジュが使用
せいこうりん	聖煌輪	名詞	
がとつひえんしょう	牙突飛燕衝	名詞	
こうはれんじん	光波連刃	名詞	
くうしゅうせんこうしょう	空襲閃光翔	名詞	
げっせんしゅうついじん	月閃襲追刃	名詞	
しゅんじんせんれつは	瞬迅閃裂破	名詞	
しゅんじんせんれっぱ	瞬迅閃裂破	名詞	
れんがひしょうじん	連牙飛翔刃	名詞	
ほうりゅうざんこうじん	崩龍斬光刃	名詞	
てんしょうこうはじん	天翔光波刃	名詞	
こうよくせいだんこう	光翼聖断煌	名詞	
ほうよくしてんしょう	鳳翼熾天翔	名詞	
せんじんそう	旋神槍	名詞	
せんじんじゅうげきそう	尖迅銃撃槍	名詞	
がとりんぐいびる	ガトリングイビル	名詞	ToI-R リカルドが使用
ぶれいくしゅーと	ブレイクシュート	名詞	ToI-R リカルドが使用
ふぁんとむ・こーる	ファントム・コール	名詞	
ふぁんとむこーる	ファントム・コール	名詞	
えんどれすとらじでぃ	エンドレス・トラジディ	名詞	
えんどれすとらじでぃ	Eトラジディ	名詞	
えんどれす・とらじでぃ	エンドレス・トラジディ	名詞	
えんどれす・とらじでぃ	Eトラジディ	名詞	
こくうらく	弧空落	名詞	
りゅうおうてんく	竜皇天駆	名詞	ToI エルマーナが使用
さいがばくりゅうけん	砕牙爆竜拳	名詞	ToI エルマーナが使用
がりゅうそう	臥竜爪	名詞	
そうがしょう	双牙翔	名詞	ToI-R エルマーナが使用
さいしゅうらく	砕蹴落	名詞	
しょうていは	衝底破	名詞	TOI-R エルマーナが使用
ばくりゅうけん	爆龍拳	名詞	TOI-R エルマーナが使用
れっこうだん	烈洸弾	名詞	
れつこうだん	烈洸弾	名詞	
ごうりゅうせん	轟龍穿	名詞	
ようそうしゅうらい	鷹爪蹴雷	名詞	
てんしょうりゅうじんきゃく	天翔龍神脚	名詞	
ちさいがくがんげき	地砕嶽岩撃	名詞	
しょうおうめっさいげき	翔王滅砕撃	名詞	
しょうおうめつさいげき	翔王滅砕撃	名詞	
ししほうりゅうけん	獅子崩竜拳	名詞	
りゅうおうてんく	龍凰天駆	名詞	ToI-R エルマーナが使用
むげんれんがしょう	夢幻連牙昇	名詞	
れんごくばくえんてんしょうは	煉獄爆炎天衝波	名詞	
れんごくばくえん	煉獄爆炎天衝波	名詞	
りゅうがてんけつせん	龍牙点穴穿	名詞	
せいりゅうほうてんれつ	聖龍崩天烈	名詞	
いんぺりある・すぴあ	インペリアル・スピア	名詞	
いんぺりあるすぴあ	インペリアル・スピア	名詞	
ひけんふうばく	秘剣封縛	名詞	
せいこんれいじゅ	青魂零呪	名詞	
おうからんぶ	桜花乱舞	名詞	
もーたるしゃどう	モータル・シャドウ	名詞	
もーたる・しゃどう	モータル・シャドウ	名詞	
ぶらっどふぁんぐ	ブラッド・ファング	名詞	
ぶらっど・ふぁんぐ	ブラッド・ファング	名詞	
ぶらっでぃ・いんぱくと	B・インパクト	名詞	
ぶらっでぃ・いんぱくと	ブラッディ・インパクト	名詞	
ぶらっでぃいんぱくと	B・インパクト	名詞	
ぶらっでぃいんぱくと	ブラッディ・インパクト	名詞	
えひとしゅわるつ	エヒト・シュワルツ	名詞	
えひと・しゅわるつ	エヒト・シュワルツ	名詞	
ぱにっしゅめんとぱーみっと	Pパーミット	名詞	
ぱにっしゅめんとぱーみっと	パニッシュメント・パーミット	名詞	
ぱにっしゅめんと・ぱーみっと	Pパーミット	名詞	
ぱにっしゅめんと・ぱーみっと	パニッシュメント・パーミット	名詞	
ぱにっしゅめんとぱーみっと	P・パーミット	名詞	ToI-R アルベールが使用
ぱにっしゅめんと・ぱーみっと	P・パーミット	名詞	ToI-R アルベールが使用
さつげきそう	殺撃槍	名詞	
せんぷうそう・ついれん	旋風槍・追連	名詞	
せんぷうそうついれん	旋風槍・追連	名詞	
てんはごうらいそう	天破剛雷槍	名詞	
れっしんらいこうげき	烈震雷光撃	名詞	
れつしんらいこうげき	烈震雷光撃	名詞	
れんぶらさっそう	煉舞羅刹槍	名詞	
れんぶらさつそう	煉舞羅刹槍	名詞	
ごうほうしゅうげき	轟崩襲撃	名詞	
まじんけん・おうが	魔神剣・王牙	名詞	
まじんけんおうが	魔神剣・王牙	名詞	
まおうぜっそうじん	魔王絶葬陣	名詞	
まおうぜつそうじん	魔王絶葬陣	名詞	
しゅんじんげっかしょう	瞬迅月華衝	名詞	
しゅんじんげつかしょう	瞬迅月華衝	名詞	
ぐれんしゅうそうじん	紅蓮襲爪刃	名詞	
ぐれんしゅんじんしょう	紅蓮瞬迅衝	名詞	
めいこうしゅうれつせん	冥光襲烈閃	名詞	
めいこうしゅうれっせん	冥光襲烈閃	名詞	
めいこうしゅうれつじん	冥光襲烈陣	名詞	
まおうかいめつじん	魔王界滅刃	名詞	
しはつこう	獅髪候	名詞	
しっくうろうえんしょう	疾空狼焔衝	名詞	
しつくうろうえんしょう	疾空狼焔衝	名詞	
おうがらんぶ	央華乱舞	名詞	
おうからんぶ	央華乱舞	名詞	
じんくうだん	迅空断	名詞	
こんごうしん	金剛震	名詞	
げっちょうこう	月長皇	名詞	
げつちょうこう	月長皇	名詞	
ぶらいじん	無頼刃	名詞	
むらいじん	無頼刃	名詞	
れいごうけん	霊鋼剣	名詞	
れいこうけん	霊鋼剣	名詞	
かれんそうぶ	華煉想無	名詞	
かれんそうむ	華煉想無	名詞	
がいりんは	凱凜刃	名詞	
そうてんざんぶ	蒼天散舞	名詞	
そうてんさんむ	蒼天散舞	名詞	
じんこくむめいけん	靱哭無銘剣	名詞	
しきいきめいとつは	識閾命突覇	名詞	
がれんげき	瓦錬撃	名詞	
りゅうせいえんぶ	龍声燕武	名詞	
りゅうこめいしょうげき	龍虎明掌撃	名詞	
がてんほう	我天峰	名詞	
しゅんろうけん	瞬狼剣	名詞	
げきりんだん	逆鱗断	名詞	
まじんざんしょうけん	魔神斬翔剣	名詞	
ざんくうれっぱ	斬空裂破	名詞	
ざんくうれつは	斬空裂破	名詞	
ごうれつばくしんけん	轟裂驀進剣	名詞	
ろうがてんしょうけん	狼牙天翔剣	名詞	
りゅうれんだん	流連弾	名詞	モバイルToC セフィナが使用
そうついしょう	双墜鐘	名詞	
れんてんぶ	蓮転舞	名詞	
ひしょうつい	飛翔墜	名詞	
じゃっきしょう	蛇騎衝	名詞	
じゃきしょう	蛇騎衝	名詞	
みだれざくら	乱れ桜	名詞	
りゅうがざん	龍牙斬	名詞	
らいぶ	雷舞	名詞	
そうりゅうえんぶ	双龍円舞	名詞	
かみかぜ	神風	名詞	
かいとうらんま	快刀乱麻	名詞	
しでんいっせん	紫電一閃	名詞	
げんろうせん	幻楼閃	名詞	
ぶしんこくうざん	武神虚空斬	名詞	
ぶじんこくうざん	武神虚空斬	名詞	
じょかつこう	浄活洸	名詞	
れんぶざん	蓮舞斬	名詞	
ぜっぱしょう	絶破衝	名詞	
ぜつはしょう	絶破衝	名詞	
ざんしゅうまざん	暫襲魔斬	名詞	
ごうじんざん	轟塵斬	名詞	
ざんえいごうれっぱ	惨影轟烈破	名詞	
ざんえいごうれつは	惨影轟烈破	名詞	
しょうはざんおうけん	翔覇斬皇剣	名詞	
しゅんせん	瞬閃	名詞	
つむじ	旋風	名詞	
ざんしゅう	斬鷲	名詞	
しぐれ	時雨	名詞	
れっか	烈火	名詞	
さいが	砕牙	名詞	
ひょうじん	氷刃	名詞	
せんじゅ	千樹	名詞	
ひょうえん	氷炎	名詞	
てんらい	天雷	名詞	
めっとう・あらがみ	滅刀・荒神	名詞	
めつとう・あらがみ	滅刀・荒神	名詞	
めっとうあらがみ	滅刀・荒神	名詞	
めつとうあらがみ	滅刀・荒神	名詞	
ぜっとう・りゅうりん	絶刀・龍鱗	名詞	
ぜつとう・りゅうりん	絶刀・龍鱗	名詞	
ぜっとうりゅうりん	絶刀・龍鱗	名詞	
ぜつとうりゅうりん	絶刀・龍鱗	名詞	
こげつせん	狐月閃	名詞	モバイルToW カルルが使用
しょうがさい	翔牙砕	名詞	
そうせんごうげき	双旋豪撃	名詞	
ばくめつついほうげき	爆滅墜崩撃	名詞	
ほうしゅうきゃく	崩蹴脚	名詞	ラタトスクの騎士 エミルが使用
こらんしゅう	虎乱蹴	名詞	ラタトスクの騎士 エミルが使用
せんこうは	穿孔破	名詞	
しゅんれんじん	瞬連刃	名詞	ラタトスクの騎士 エミルが使用
じゅうしょうらい	獣招来	名詞	ラタトスクの騎士 エミルが使用
ほうよくせん	鳳翼旋	名詞	
くうがしょう	空牙衝	名詞	
しゅうそうがんざんは	襲爪岩斬破	名詞	
れっぱぜっしょうげき	裂破絶掌撃	名詞	
れつはぜっしょうげき	裂破絶掌撃	名詞	
てんしょうれっくうげき	天衝裂空撃	名詞	
てんしょうれつくうげき	天衝裂空撃	名詞	
まじんせんこうだん	魔神閃光断	名詞	
さいはそうげきしょう	砕覇双撃衝	名詞	
らいじんれっこうさつ	雷神烈光刹	名詞	
らいじんれつこうさつ	雷神烈光刹	名詞	
がれんごうてんしゅう	牙連轟天襲	名詞	
ごうませんこうきゃく	降魔穿光脚	名詞	
ここうれつざんし	虎咬裂斬刺	名詞	
まおうごくえんは	魔王獄炎波	名詞	
あいんそふあうる	アイン・ソフ・アウル	名詞	
あいん・そふ・あうる	アイン・ソフ・アウル	名詞	
てんしょうぶ	天翔舞	名詞	
えんぶざん	燕舞斬	名詞	
ひえんりゅうぶ	飛燕流舞	名詞	
ほうおうしんきゃく	鳳凰震脚	名詞	
しっぷうこうじん	疾風煌塵	名詞	
れっぷうえんは	烈風燕波	名詞	
ざんえいしょう	残影掌	名詞	
れいでぃあんとろあー	レイディアント・ロアー	名詞	
れいでぃあんと・ろあー	レイディアント・ロアー	名詞	
あるすのう゛ぁ	アルス・ノヴァ	名詞	
あるす・のう゛ぁ	アルス・ノヴァ	名詞	
あるすのゔぁ	アルス・ノヴァ	名詞	
あるす・のゔぁ	アルス・ノヴァ	名詞	
ようりゅうきのえ	陽流・甲	名詞	
ようりゅうかのえ	陽流・庚	名詞	
ようりゅうみずのえ	陽流・壬	名詞	
ようりゅうつちのえ	陽流・戊	名詞	
ようりゅうひのえ	陽流・丙	名詞	
いんりゅうきのと	陰流・乙	名詞	
いんりゅうひのと	陰流・丁	名詞	
いんりゅうつちのと	陰流・己	名詞	
いんりゅうみずのと	陰流・癸	名詞	
いんりゅうかのと	陰流・辛	名詞	
ようりゅう・きのえ	陽流・甲	名詞	
ようりゅう・かのえ	陽流・庚	名詞	
ようりゅう・みずのえ	陽流・壬	名詞	
ようりゅう・つちのえ	陽流・戊	名詞	
ようりゅう・ひのえ	陽流・丙	名詞	
いんりゅう・きのと	陰流・乙	名詞	
いんりゅう・ひのと	陰流・丁	名詞	
いんりゅう・つちのと	陰流・己	名詞	
いんりゅう・みずのと	陰流・癸	名詞	
いんりゅう・かのと	陰流・辛	名詞	
ようりゅう	陽流	名詞	
いんりゅう	陰流	名詞	
ようりゅう	陽流・甲	名詞	キノエ
ようりゅう	陽流・庚	名詞	カノエ
ようりゅう	陽流・壬	名詞	ミズノエ
ようりゅう	陽流・戊	名詞	ツチノエ
ようりゅう	陽流・丙	名詞	ヒノエ
いんりゅう	陰流・乙	名詞	キノト
いんりゅう	陰流・丁	名詞	ヒノト
いんりゅう	陰流・己	名詞	ツチノト
いんりゅう	陰流・癸	名詞	ミズノト
いんりゅう	陰流・辛	名詞	カノト
たわーりんぐいんふぇるの	タワーリング・インフェルノ	名詞	ラタトスクの騎士 リヒターが使用
たわーりんぐ・いんふぇるの	タワーリング・インフェルノ	名詞	ラタトスクの騎士 リヒターが使用
えたーなるりかーらんす	エターナル・リカーランス	名詞	ラタトスクの騎士 リヒターが使用
えたーなる・りかーらんす	エターナル・リカーランス	名詞	ラタトスクの騎士 リヒターが使用
えんていけんぶれん	炎帝剣舞連	名詞	
かえんれっくう	火炎烈空	名詞	ラタトスクの騎士 ロイド、ToVのカロルが使用
かえんれつくう	火炎烈空	名詞	ラタトスクの騎士 ロイドが使用
しょうはそうてんざん	翔破蒼天斬	名詞	
ほーりーじゃっじめんと	ホーリー・ジャッジメント	名詞	ラタトスクの騎士 コレットが使用
はくろうげき	白狼撃	名詞	
しょうせいふりゅうきゃく	照星浮龍脚	名詞	
さつげきぶこうけんとんろう	殺劇舞荒拳・貪狼	名詞	
さつげきぶこうけん・とんろう	殺劇舞荒拳・貪狼	名詞	
ほうこう	咆哮	名詞	
すなぼこり	砂埃	名詞	
ちょうはつ	挑発	名詞	
りゅうがそう	竜牙槍	名詞	
はなあらし	花嵐	名詞	
とりかげ	鳥影	名詞	
げっこう	月光	名詞	
かざぐも	風雲	名詞	
めいきょうしすい	明鏡止水	名詞	
あうすぶるっふ	D.アウスブルッフ	名詞	
しゅたいんはーげる	D.シュタインハーゲル	名詞	
しゅとらーる	D.シュトラール	名詞	
しゅとるむう゛ぃんと	D.シュトルムヴィント	名詞	
しゅとるむゔぃんと	D.シュトルムヴィント	名詞	
とろんべ	D.トロンベ	名詞	
らう゛ぃーね	D.ラヴィーネ	名詞	
らゔぃーね	D.ラヴィーネ	名詞	
しゅとるむうんとどらんく	シュトルム・ウント・ドランク	名詞	
しゅとるむ・うんと・どらんく	シュトルム・ウント・ドランク	名詞	
あかとくろ	赤と黒	名詞	
てんしのゆめ	天使の夢	名詞	
おとめのいのり	乙女の祈り	名詞	
じごくのきせつ	地獄の季節	名詞	
せんそうとへいわ	戦争と平和	名詞	
らいめいといなづま	雷鳴と稲妻	名詞	
ふゆのひのげんそう	冬の日の幻想	名詞	
たかめられしちとにくと	高められし血と肉と	名詞	
てんろうはくげきしょう	天狼魄撃掌	名詞	
むむみょうやくむ	無無明亦無	名詞	
ばつざんがいせい	跋山蓋世	名詞	
せいかりょうげん	星禍燎原	名詞	
むげんほうよう	無幻泡影	名詞	
るてんりんね	流天輪廻	名詞	
おうどうらくど	王道烙土	名詞	
かうんきほう	夏雲奇砲	名詞	
げっかひょうじん	月下氷刃	名詞	
こうぼういっせん	光昴一閃	名詞	
しざんけつが	屍山渇河	名詞	
きょうかすいげつ	狂花水月	名詞	
えんしん・ほたるび	焔心・蛍火	名詞	
えんしんほたるび	焔心・蛍火	名詞	
ごうか・かいじん	劫火・灰燼	名詞	
ごうかかいじん	劫火・灰燼	名詞	
しんか・かげろう	神火・陽炎	名詞	
しんかかげろう	神火・陽炎	名詞	
じんか・かげろう	神火・陽炎	名詞	
じんかかげろう	神火・陽炎	名詞	
しょうしゃく・ぐれん	焼灼・紅蓮	名詞	
しょうしゃくぐれん	焼灼・紅蓮	名詞	
むとうりゅう	無刀流	名詞	
あらぬえしき	荒鵺式	名詞	
むとうりゅう・あらぬえしき	無刀流・荒鵺式	名詞	
むとうりゅうあらぬえしき	無刀流・荒鵺式	名詞	
くおん	苦怨	名詞	
にとうりゅう・くおん	二刀流・苦怨	名詞	
にとうりゅうくおん	二刀流・苦怨	名詞	
がしゅう	我讐	名詞	
にとうりゅう・がしゅう	二刀流・我讐	名詞	
にとうりゅうがしゅう	二刀流・我讐	名詞	
よんとうりゅう	四刀流	名詞	
ほうじん	報刃	名詞	
よんとうりゅう・ほうじん	四刀流・報刃	名詞	
よんとうりゅうほうじん	四刀流・報刃	名詞	
りくどう	戮道	名詞	
よんとうりゅう・りくどう	四刀流・戮道	名詞	
よんとうりゅうりくどう	四刀流・戮道	名詞	
じっかい	十壊	名詞	
よんとうりゅう・じっかい	四刀流・十壊	名詞	
よんとうりゅうじっかい	四刀流・十壊	名詞	
えんま	怨魔	名詞	
よんとうりゅう・えんま	四刀流・怨魔	名詞	
よんとうりゅうえんま	四刀流・怨魔	名詞	
そうがしょう	双牙掌	名詞	ToV ユーリが使用
がろうげき	牙狼撃	名詞	
ばくさいじん	爆砕陣	名詞	
えんせんが	円閃牙	名詞	ToV ユーリが使用
げんろうざん	幻狼斬	名詞	
りゅうじんしょう	竜刃翔	名詞	
そうはがおうげき	蒼破牙王撃	名詞	
れっさいしょうは	烈砕衝破	名詞	
れつさいしょうは	烈砕衝破	名詞	
だんくうが	断空牙	名詞	
ぎしょうせん	義翔閃	名詞	
しゅんえんかざん	峻円華斬	名詞	
ごうれっしゅう	噛烈襲	名詞	
ごうれつしゅう	噛烈襲	名詞	
こくうれっしゅうげき	哭空裂蹴撃	名詞	
こくうれつしゅうげき	哭空裂蹴撃	名詞	
せんじんろうは	戦迅狼破	名詞	
ぜっぷうじん	絶風刃	名詞	
ぜつふうじん	絶風刃	名詞	
ひえんもうしゅうが	飛燕猛襲牙	名詞	
ろうはせんれっしゅう	狼破千烈襲	名詞	
ろうはせんれつしゅう	狼破千烈襲	名詞	
そうがじん	蒼牙刃	名詞	
さざんか・ついれん	三散華・追蓮	名詞	
さざんかついれん	三散華・追蓮	名詞	
えんせんしゅうらく	円閃襲落	名詞	
こくうぐれんげき	哭空紅蓮撃	名詞	
ふうじんろうは	風塵狼破	名詞	
しゃんは	遮波	名詞	
れっぱらんしょう	烈破乱掌	名詞	
れつはらんしょう	烈破乱掌	名詞	
てんろうめつが	天狼滅牙	名詞	
てんろうめつが・ひえん	天狼滅牙・飛炎	名詞	
てんろうめつがひえん	天狼滅牙・飛炎	名詞	
てんろうめつが・さいは	天狼滅牙・砕覇	名詞	
てんろうめつがさいは	天狼滅牙・砕覇	名詞	
てんろうめつが・ふうじん	天狼滅牙・風迅	名詞	
てんろうめつがふうじん	天狼滅牙・風迅	名詞	
てんろうめつが・すいれん	天狼滅牙・水蓮	名詞	
てんろうめつがすいれん	天狼滅牙・水蓮	名詞	
ざんこうろうえいじん	漸毅狼影陣	名詞	
てんしょうこうよくけん	天翔光翼剣	名詞	
ぶしんそうてんは	武神双天波	名詞	
すたーさいん・ふれいむ	スターサイン・フレイム	名詞	
すたーさいんふれいむ	スターサイン・フレイム	名詞	
すたーさいん・じお	スターサイン・ジオ	名詞	
すたーさいんじお	スターサイン・ジオ	名詞	
すたーさいん・げいる	スターサイン・ゲイル	名詞	
すたーさいんげいる	スターサイン・ゲイル	名詞	
すたーさいん・あくあ	スターサイン・アクア	名詞	
すたーさいんあくあ	スターサイン・アクア	名詞	
しゅんじんけん	瞬迅犬	名詞	ToV ラピードが使用
こくうせんが	弧空旋牙	名詞	
れっせんが	裂旋牙	名詞	
れつせんが	裂旋牙	名詞	
りゅうえいが	流影牙	名詞	
まじんけん	魔神犬	名詞	ToV ラピードが使用
ごうまじんけん	剛魔神犬	名詞	
しっぷうけん	疾風犬	名詞	
げんえいけん	幻鋭犬	名詞	
せんくうけん	閃空犬	名詞	ToV ラピードが使用
しゅんじんかいき	瞬迅回帰	名詞	
せんくうれっぱ	閃空烈破	名詞	ToV ラピード、ザギ、闘技場クラトスが使用
せんくうれつは	閃空烈破	名詞	ToV ラピード、ザギ、闘技場クラトスが使用
そうりゅうれつとうが	爪竜烈濤牙	名詞	
そうりゅうれっとうが	爪竜烈濤牙	名詞	
げんえい・さいが	幻影・砕牙	名詞	
げんえいさいが	幻影・砕牙	名詞	
ぐれんけん	紅蓮犬	名詞	ToV ラピードが使用
ぐれんかいき	紅蓮回帰	名詞	
むえいろうが	無影狼牙	名詞	
らいじんけん	雷神犬	名詞	ToV ラピードが使用
まじんけん・そうが	魔神犬・走牙	名詞	ToV ラピードが使用
まじんけんそうが	魔神犬・走牙	名詞	ToV ラピードが使用
しゅんじんごうが	瞬迅噛牙	名詞	
せんくうしょうれつは	閃空衝烈破	名詞	ToV ラピード、ザギが使用
せんくうしょうれっぱ	閃空衝烈破	名詞	ToV ラピード、ザギが使用
げんえい・ひょうが	幻影・氷河	名詞	
げんえいひょうが	幻影・氷河	名詞	
こくうれっせんが	虚空裂旋牙	名詞	
こくうれつせんが	虚空裂旋牙	名詞	
そうりゅうれっくうは	爪竜烈空波	名詞	
そうりゅうれつくうは	爪竜烈空波	名詞	
ひようりゅうすいじん	飛葉流水陣	名詞	
てんろうじんが	天狼迅牙	名詞	
てんろうじんが・きょうえん	天狼迅牙・狂炎	名詞	
てんろうじんがきょうえん	天狼迅牙・狂炎	名詞	
てんろうじんが・しんげき	天狼迅牙・震撃	名詞	
てんろうじんがしんげき	天狼迅牙・震撃	名詞	
てんろうじんが・ちゅうは	天狼迅牙・宙覇	名詞	
てんろうじんがちゅうは	天狼迅牙・宙覇	名詞	
てんろうじんが・すいか	天狼迅牙・水禍	名詞	
てんろうじんがすいか	天狼迅牙・水禍	名詞	
ざん	斬！！	名詞	ToV ラピードが使用
ざん!!	斬！！	名詞	ToV ラピードが使用
るどるふ	β×Ψ＝√	名詞	
ふぃー	ζ×Ψ＝Φ	名詞	
でかると	∠＝(x,y,z)	名詞	
らぷらす	ζ＝δτ(ωρ)	名詞	
うぉりす	∠＝∞	名詞	
いである	(δ／χ)λ＝ι	名詞	
いである	(δ/χ)λ＝ι	名詞	
すとーくす	∫∇=Σ(ωπ)	名詞	
ぽうらー	∠＝(r,θ,φ)	名詞	
ぽうらー	∠＝(r,θ,Φ)	名詞	
あるてぃん	Α＝Iк{λ∈Λ}	名詞	
すぷれっどぜろ	スプレッドゼロ	名詞	ToV リタが使用
がりょうあっぱー	臥龍アッパー	名詞	
がりゅうあっぱー	臥龍アッパー	名詞	ガリョウアッパー
ばくさいろっく	爆砕ロック	名詞	
かっしんえいどすたんぷ	活心エイドスタンプ	名詞	
かつしんえいどすたんぷ	活心エイドスタンプ	名詞	
らっぱぺいんしょっと	落破ペインショット	名詞	
らくはぺいんしょっと	落破ペインショット	名詞	
らいげきうぇーぶ	雷撃ウェーブ	名詞	
かっしんりかばーすたんぷ	活心リカバースタンプ	名詞	
かつしんりかばーすたんぷ	活心リカバースタンプ	名詞	
げきちゅうぶれす	撃虫ブレス	名詞	
ごくえんぶれす	獄炎ブレス	名詞	
れっせんすまっしゅ	裂旋スマッシュ	名詞	
れつせんすまっしゅ	裂旋スマッシュ	名詞	
しんらばんしょうばっぐ	森羅万象バッグ	名詞	
らっぱすぱいだーうぇぶ	落破スパイダーウェブ	名詞	
らくはすぱいだーうぇぶ	落破スパイダーウェブ	名詞	
ほうしゅうぶれーく	崩襲ブレーク	名詞	
ごうしょうびーと	剛招ビート	名詞	
ごうごうれぼりゅーしょん	轟々レボリューション	名詞	
らっぱぶーいんぐだんす	落破ブーイングダンス	名詞	
らくはぶーいんぐだんす	落破ブーイングダンス	名詞	
げきついふろうあっぱー	撃槌フロウアッパー	名詞	
れっせんえいどすたんぷ	裂旋エイドスタンプ	名詞	
れつせんえいどすたんぷ	裂旋エイドスタンプ	名詞	
きしんせんれつのっく	鬼神千裂ノック	名詞	
きじんせんれつのっく	鬼神千裂ノック	名詞	
きしんちょうじゅうばすたー	鬼神超重バスター	名詞	
きじんちょうじゅうばすたー	鬼神超重バスター	名詞	
しこうめつりゅうふらっしゅ	獅吼滅龍フラッシュ	名詞	
ばくそうしゅうげきぶろう	爆走襲撃ブロウ	名詞	
まおうもうしゅうらいず	魔王猛襲ライズ	名詞	
れっしんどろっぷ	烈震ドロップ	名詞	
れつしんどろっぷ	烈震ドロップ	名詞	
きゅうきょくしんさつですとろい	究極神殺デストロイ	名詞	
ばくさいすとりーと	爆砕ストリート	名詞	
かっしんひーるすたんぷ	活心ヒールスタンプ	名詞	
かつしんひーるすたんぷ	活心ヒールスタンプ	名詞	
かっしんきゅあすたんぷ	活心キュアスタンプ	名詞	
かつしんきゅあすたんぷ	活心キュアスタンプ	名詞	
れっせんだぶるすまっしゅ	裂旋ダブルスマッシュ	名詞	
れつせんだぶるすまっしゅ	裂旋ダブルスマッシュ	名詞	
ほうしゅうさんだー	崩襲サンダー	名詞	
らっぱぺいんかーにばる	落破ペインカーニバル	名詞	
らくはぺいんかーにばる	落破ペインカーニバル	名詞	
らっぱぶーいんぐふぇすた	落破ブーイングフェスタ	名詞	
らくはぶーいんぐふぇすた	落破ブーイングフェスタ	名詞	
ふうふうれぼりゅーしょん	風風レボリューション	名詞	
しんきょくめっさつすぱーく	震極滅殺スパーク	名詞	
しんきょくめつさつすぱーく	震極滅殺スパーク	名詞	
ちょうがせんめつすうぃんぐ	超牙旋滅スウィング	名詞	
ちょうがせんめつひーと	超牙旋滅ヒート	名詞	
ちょうがせんめつくらっしゅ	超牙旋滅クラッシュ	名詞	
ちょうがせんめつたいふーん	超牙旋滅タイフーン	名詞	
ちょうがせんめつそうる	超牙旋滅ソウル	名詞	
ごうはれんじんいんぱくと	豪覇連刃インパクト	名詞	
ごうはれいじんいんぱくと	豪覇連刃インパクト	名詞	
ごうせんばくさつうるとらえっくすぼんばー	剛閃爆殺ウルトラXボンバー	名詞	
ごうせんばくさつ	剛閃爆殺ウルトラXボンバー	名詞	
こいのはな	恋ノ花	名詞	
もぐらなり	土竜なり	名詞	
どりゅうなり	土竜なり	名詞	モグラなり
ほたるなり	蛍なり	名詞	
てんのひらめき	天の閃き	名詞	
まわるけしき	回る景色	名詞	
あいのかいしん	愛の快針	名詞	
くろのついせき	黒の追跡	名詞	
しおんのへび	紫苑の蛇	名詞	
しおんのいたち	紫苑の鼬	名詞	
まうがごとく	舞うが如く	名詞	
みどりのせつな	碧の刹那	名詞	
くれないのらせん	紅の螺旋	名詞	
てんるい	天涙	名詞	
ちるように	散るように	名詞	
とぶように	飛ぶように	名詞	
てんのなげき	天の嘆き	名詞	
ながれぼし	流れ星	名詞	
つみとばつ	罪と罰	名詞	
つみとばつ・つみ	罪と罰・罪	名詞	
つみとばつつみ	罪と罰・罪	名詞	
つみとばつ・ばつ	罪と罰・罰	名詞	
つみとばつばつ	罪と罰・罰	名詞	
かぜのたけり	風の哮り	名詞	
かぜのたけり	風の猛り	名詞	
しぐれのおと	時雨の音	名詞	
そうてんのひらめき	蒼天の閃き	名詞	
まわるまわるけしき	回る回る景色	名詞	
てんるいのあめ	天涙の雨	名詞	
てんるいのくも	天涙の雲	名詞	
なお、ちるように	尚、散るように	名詞	
なおちるように	尚、散るように	名詞	
ひろがるせかい	拡がる世界	名詞	
ふんげきのらん	憤激の乱	名詞	
しゅうかのらん	襲火の乱	名詞	
こんごうのらん	金剛の乱	名詞	
じんぷうのらん	神風の乱	名詞	
しゅううのらん	驟雨の乱	名詞	
ありーう゛ぇでるち	アリーヴェデルチ	名詞	
ありーゔぇでるち	アリーヴェデルチ	名詞	
ありーべでるち	アリーヴェデルチ	名詞	
げつが	月牙	名詞	
ほうしゅうげつ	崩襲月	名詞	
きさらぎ	如月	名詞	
ひえんげっか	飛燕月華	名詞	
ざんげつ	残月	名詞	
しんげつれっぱ	神月烈破	名詞	
しんげつれつは	神月烈破	名詞	
ぶらしれっぱ	ブラシ烈破	名詞	
ぶらしれつは	ブラシ烈破	名詞	
らんげつ	嵐月	名詞	
せんげつ	尖月	名詞	
ふうげつ	風月	名詞	
せんげつじん	旋月刃	名詞	
げっかてんしょうじん	月華天翔刃	名詞	
えんげつ	円月	名詞	
ひえんほうしゅうげつ	飛燕崩襲月	名詞	
げっこう・からす	月光・烏	名詞	
げっこうからす	月光・烏	名詞	
しょうぶそうげつせん	翔舞槍月閃	名詞	
らいじんげつえいか	雷神月詠華	名詞	
げっぱついじんきゃく	月破墜迅脚	名詞	
げつはついじんきゃく	月破墜迅脚	名詞	
らくげつそう	落月爪	名詞	
げつが・たか	月牙・鷹	名詞	
げつがたか	月牙・鷹	名詞	
ひえんれんげっか	飛燕連月華	名詞	
らんげつ・つばめ	嵐月・燕	名詞	
らんげつつばめ	嵐月・燕	名詞	
えんげつ・とんび	円月・鳶	名詞	
えんげつとんび	円月・鳶	名詞	
ざんげつ・はやぶさ	残月・隼	名詞	
ざんげつはやぶさ	残月・隼	名詞	
すいげつじん	彗月陣	名詞	
てんらいそうげつ	天雷槍月	名詞	
げっぱしでんきゃく	月破紫電脚	名詞	
げつはしでんきゃく	月破紫電脚	名詞	
げつえいせんじん	月影尖刃	名詞	
ふうじんしょうげっか	封塵衝月華	名詞	
えんかふうばくしょう	炎華封爆衝	名詞	
ちがくふうしょうじん	地額封晶塵	名詞	
そうかげつばくふう	蒼華月瀑封	名詞	
こうかげっしょうせん	煌華月衝閃	名詞	
こうかげつしょうせん	煌華月衝閃	名詞	
はおうろうげつそう	覇王籠月槍	名詞	
ごう・ぐれんけん	剛・紅蓮剣	名詞	
ごうぐれんけん	剛・紅蓮剣	名詞	
こうしょうよく	光翔翼	名詞	
こうしょうよく・さん	光翔翼・散	名詞	
こうしょうよくさん	光翔翼・散	名詞	
こうはせんしょうじん	光破旋衝陣	名詞	
こうしょうせんめつじん	光翔戦滅陣	名詞	
こうしょうせんめつじん・しえん	光翔戦滅陣・獅炎	名詞	
こうしょうせんめつじんしえん	光翔戦滅陣・獅炎	名詞	
こうしょうせんめつじん・しんざん	光翔戦滅陣・震斬	名詞	
こうしょうせんめつじんしんざん	光翔戦滅陣・震斬	名詞	
こうしょうせんめつじん・せんじん	光翔戦滅陣・旋迅	名詞	
こうしょうせんめつじんせんじん	光翔戦滅陣・旋迅	名詞	
こうしょうせんめつじん・そうだん	光翔戦滅陣・蒼弾	名詞	
こうしょうせんめつじんそうだん	光翔戦滅陣・蒼弾	名詞	
こうりゅうめつがそう	光竜滅牙槍	名詞	
えんはほうよくしょう	炎覇鳳翼翔	名詞	
ちーといつ	七対七	名詞	
こくしむそう	国士無双	名詞	
きりぎりす	斬り斬りス	名詞	
きりきりす	斬り斬りス	名詞	
もさのじゃがん	猛者の蛇眼	名詞	
ちゅうはゆうげき	宙覇遊撃	名詞	
こくいんじゅうじざん	刻印十字斬	名詞	
だっかつらいれん	奪活雷連	名詞	
もうしんよんれんげき	猛進四連撃	名詞	
ほうそうしょうげきは	彷走衝撃波	名詞	
くうはとっこうだん・ほう	空破特攻弾・崩	名詞	
くうはとっこうだんほう	空破特攻弾・崩	名詞	
まどうえんちゅうしょう	魔導炎柱昇	名詞	
まどうえんばくしょう	魔導炎爆衝	名詞	
ひつめつあくむさん	必滅悪霧散	名詞	
ひつめつきょうむらん	必滅凶霧乱	名詞	
まどうきゅういん	魔導吸引	名詞	
まどうきょうみ	魔導凶身	名詞	
まどうこうせんかん	魔導光穿貫	名詞	
まどうこうせんさつ	魔導光殲殺	名詞	
まどうこうてんじん	魔導光天陣	名詞	
ひらいじん	飛来刃	名詞	
とうほざん	踏歩斬	名詞	
せんてんざん	旋転斬	名詞	
れっしんざん	烈震斬	名詞	
れつしんざん	烈震斬	名詞	
ひらいじん・えんりん	飛来刃・円輪	名詞	
ひらいじんえんりん	飛来刃・円輪	名詞	
ひらいじん・きょうしゅう	飛来刃・強襲	名詞	
ひらいじんきょうしゅう	飛来刃・強襲	名詞	
ちょうひらいじん・ばくえんざん	超飛来刃・爆炎斬	名詞	
ちょうひらいじんばくえんざん	超飛来刃・爆炎斬	名詞	
みずちやいば	蛟龍刃	名詞	
まいみずち	舞蛟龍	名詞	
まいみずち「かまいたち」	舞蛟龍「窮奇」	名詞	
まいみずちかまいたち	舞蛟龍「窮奇」	名詞	
かまいたち	窮奇	名詞	
みずちやいば「おぼろぐるま」	蛟龍刃「朧車」	名詞	
みずちやいばおぼろぐるま	蛟龍刃「朧車」	名詞	
おぼろぐるま	朧車	名詞	
みずちやいば「きこく」	蛟龍刃「鬼哭」	名詞	
みずちやいばきこく	蛟龍刃「鬼哭」	名詞	
きこく	鬼哭	名詞	
まいみずち「あぎと」	舞蛟龍「顎門」	名詞	
まいみずちあぎと	舞蛟龍「顎門」	名詞	
あぎと	顎門	名詞	
みずちやいば「まいくび」	蛟龍刃「舞頚」	名詞	
みずちやいばまいくび	蛟龍刃「舞頚」	名詞	
まいくび	舞頚	名詞	
みずちやいば「こうりん」	蛟龍刃「降臨」	名詞	
みずちやいばこうりん	蛟龍刃「降臨」	名詞	
こうりん	降臨	名詞	
まいみずち「はどう」	舞蛟龍「覇道」	名詞	
まいみずちはどう	舞蛟龍「覇道」	名詞	
はどう	覇道	名詞	
みずちやいば「あくろおう」	蛟龍刃「悪路王」	名詞	
みずちやいばあくろおう	蛟龍刃「悪路王」	名詞	
あくろおう	悪路王	名詞	
ばくさいは	爆砕波	名詞	
れっせんじん	裂旋刃	名詞	
こうせんしょう	鋼穿衝	名詞	
ばくがついげき	縛牙槌撃	名詞	
はおうもうしゅうげき	覇王猛襲撃	名詞	
ごく・ふぇいたるすとらいく	極・フェイタルストライク	名詞	
ごくふぇいたるすとらいく	極・フェイタルストライク	名詞	
ふうが	風牙	名詞	
じれんばくしょう	時練爆鐘	名詞	
こうりゅうそう	光竜槍	名詞	ToV アレクセイが使用
はじゃちりゅうじん	破邪地竜陣	名詞	
せんはらんせいじん	閃覇嵐星塵	名詞	
しょうは	衝波	名詞	ToV デュークが使用
らせつけん	羅刹剣	名詞	
てんがりゅうしょう	天牙竜昇	名詞	
れっせんしょうが	裂尖衝牙	名詞	
れつせんしょうが	裂尖衝牙	名詞	
えんせんらんぶ	円閃乱舞	名詞	
もうがこうおうしょう	猛牙紅皇衝	名詞	
ぐれんごうてんは	紅蓮剛天覇	名詞	
めっさいてんぶ	滅砕天舞	名詞	
めつさいてんぶ	滅砕天舞	名詞	
めっさいてんこうは	滅砕天光覇	名詞	
めつさいてんこうは	滅砕天光覇	名詞	
ぶれいぶう゛ぇすぺりあ	凛々の明星	名詞	
ぶれいぶゔぇすぺりあ	凛々の明星	名詞	
りりのあかぼし	凛々の明星	名詞	
りんりんのみょうじょう	凛々の明星	名詞	ブレイブヴェスペリア
そうびりん	薔薇輪	名詞	
たちかげ	太刀影	名詞	
ほうおうのえん	鳳凰の宴	名詞	
しょうてん	衝天	名詞	
えたーなるふぁいなりてぃ	エターナルファイナリティ	名詞	ToV 闘技場シゼルが使用
なげ	投げ	名詞	
ふみつけ	踏みつけ	名詞	
おとこのふりあげ	漢の振り上げ	名詞	
あいてむなぞつかってんじゃねえ	アイテムなぞ使ってんじゃねえ！	名詞	ToV 闘技場バルバトスが使用
あいてむなぞつかってんじゃねぇ	アイテムなぞ使ってんじゃねえ！	名詞	ToV 闘技場バルバトスが使用
あいてむなぞつかってんじゃねえ!	アイテムなぞ使ってんじゃねえ！	名詞	ToV 闘技場バルバトスが使用
あいてむなぞつかってんじゃねぇ!	アイテムなぞ使ってんじゃねえ！	名詞	ToV 闘技場バルバトスが使用
あいてむなぞ	アイテムなぞ使ってんじゃねえ！	名詞	ToV闘技場バルバトスが使用
ごうまじんけん	剛魔神剣	名詞	ToV 闘技場クラトスが使用
ぐりーばんず・ふぉーかす	グリーバンズ・フォーカス	名詞	
ぐりーばんずふぉーかす	グリーバンズ・フォーカス	名詞	
ぐりーばんず・すぷれっど	グリーバンズ・スプレッド	名詞	
ぐりーばんずすぷれっど	グリーバンズ・スプレッド	名詞	
えっくすばすたー・かい	Xバスター・カイ	名詞	
xばすたー・かい	Xバスター・カイ	名詞	
ふぁいなるえっくすばすたー	ファイナルXバスター	名詞	
ふぁいなるxばすたー	ファイナルXバスター	名詞	
とうききゅうしゅう	闘気吸収	名詞	
かいれんじん	海連刃	名詞	TOH シングが使用
りゅうせいしょう	流星衝	名詞	
ちさいしょう	地砕衝	名詞	
しょうせいじん	翔星刃	名詞	
しゅんじんしょう	瞬刃衝	名詞	
ひえんしょうせん	飛燕翔旋	名詞	
そうこうが	爪吼牙	名詞	
しじんこんごうは	思刃金剛波	名詞	
しこうれっぱ	獅吼烈破	名詞	
しこうれつは	獅吼烈破	名詞	
くうれつせん	空裂閃	名詞	
らいじんが	雷迅牙	名詞	
しょうこうじん	昇煌陣	名詞	
せいじんぜっぱ	星塵絶破	名詞	
せいじんぜつは	星塵絶破	名詞	
せいえいれっぱ	星影連波	名詞	
せいえいれんは	星影連波	名詞	
せいえいれんぱ	星影連波	名詞	
くうはてんれつじん	空破天裂陣	名詞	
ひおうぜっしょうざん	緋凰絶翔斬	名詞	
ぜっぱらいじんしょう	絶破雷迅衝	名詞	
ぜつはらいじんしょう	絶破雷迅衝	名詞	
しょうはれっせんこう	翔破裂閃光	名詞	
しょうはれつせんこう	翔破裂閃光	名詞	
じゅうこうらいは	獣哮雷波	名詞	
はじゃじゅうじせい	破邪十字星	名詞	
せんきようしょうざん	閃麒耀翔斬	名詞	
しせいれっしょうじん	獅星烈翔刃	名詞	
しせいれつしょうじん	獅星烈翔刃	名詞	
ごうはらいじんそう	轟破雷神槍	名詞	
しょうおうじんえいざん	翔旺神影斬	名詞	
さいしんきゃく	砕心脚	名詞	
しっぷうきゃく	疾風脚	名詞	
ひおうざんか	緋桜散華	名詞	
ひおうさんか	緋桜散華	名詞	
くうがらんしゅうせん	空牙嵐蹴旋	名詞	
びゃっかせんれんだん	白花旋蓮弾	名詞	
はくかせんれんだん	白花旋蓮弾	名詞	ビャッカセンレンダン
かせんりん	火旋輪	名詞	
えんぶじん	炎舞陣	名詞	
ぐれんこうりん	紅蓮皇輪	名詞	
こうがばくえんぶ	紅雅曝炎舞	名詞	
てんろうきゃく	天楼脚	名詞	
ひえんしょうじん	緋炎翔陣	名詞	
はりすずめ	針雀	名詞	
れっそうしゅう	裂想蹴	名詞	
れつそうしゅう	裂想蹴	名詞	
きりつばめ	斬燕	名詞	
あらたか	荒鷹	名詞	
はなおしどり	華鴛鴦	名詞	
やりかもめ	槍鴎	名詞	
おにはやぶさ	鬼隼	名詞	
きじなぎ	雉薙	名詞	
つむじがらす	旋風鴉	名詞	
あまづる	天鶴	名詞	
とびひさめ	鳶氷雨	名詞	
まいうずら	舞鶉	名詞	
ときつばき	朱鷺椿	名詞	
かぜふくろう	風梟	名詞	
ちりさぎ	散鷺	名詞	
かむいどり	神射鶏	名詞	
みだれちどり	乱千鳥	名詞	
あらしいすか	嵐交喙	名詞	
じんせきれい	迅鶺鴒	名詞	
あめひばり	雨雲雀	名詞	
しょうくじゃく	翔孔雀	名詞	
れっぷうせん	烈風閃	名詞	
れつふうせん	烈風閃	名詞	
つついぬわし・つがいかぜ	銃狗鷲・番風	名詞	
つついぬわしつがいかぜ	銃狗鷲・番風	名詞	
つついぬわし	銃狗鷲	名詞	
つがいかぜ	番風	名詞	
つがいかぜ	銃狗鷲・番風	名詞	ツツイヌワシ・ツガイカゼ
ひすいわざ	針雀	名詞	ハリスズメ
ひすいわざ	裂想蹴	名詞	レッソウシュウ
ひすいわざ	斬燕	名詞	キリツバメ
ひすいわざ	荒鷹	名詞	アラタカ
ひすいわざ	華鴛鴦	名詞	ハナオシドリ
ひすいわざ	槍鴎	名詞	ヤリカモメ
ひすいわざ	鬼隼	名詞	オニハヤブサ
ひすいわざ	雉薙	名詞	キジナギ
ひすいわざ	旋風鴉	名詞	ツムジガラス
ひすいわざ	天鶴	名詞	アマヅル
ひすいわざ	鳶氷雨	名詞	トビヒサメ
ひすいわざ	舞鶉	名詞	マイウズラ
ひすいわざ	朱鷺椿	名詞	トキツバキ
ひすいわざ	風梟	名詞	カゼフクロウ
ひすいわざ	散鷺	名詞	チリサギ
ひすいわざ	神射鶏	名詞	カムイドリ
ひすいわざ	乱千鳥	名詞	ミダレチドリ
ひすいわざ	嵐交喙	名詞	アラシイスカ
ひすいわざ	迅鶺鴒	名詞	ジンセキレイ
ひすいわざ	雨雲雀	名詞	アメヒバリ
ひすいわざ	翔孔雀	名詞	ショウクジャク
ひすいわざ	銃狗鷲・番風	名詞	ツツイヌワシ・ツガイカゼ
ぱにっくくりぃむ	パニックくりぃむ	名詞	
ぱにっくくりいむ	パニックくりぃむ	名詞	
ぱにっくくりーむ	パニックくりぃむ	名詞	
おらおらっしゅ	おらおRUSH	名詞	
でぃじーたいふーん	でぃじータイフーン	名詞	
でいじーたいふーん	でぃじータイフーン	名詞	
ぶりっどもんすたぁ	ブリッドもんすたぁ	名詞	
ぶりっどもんすたあ	ブリッドもんすたぁ	名詞	
ぶりっどもんすたー	ブリッドもんすたぁ	名詞	
ぐろりあすあーち	ぐろりあすアーチ	名詞	
ちれちれさんど	ちれちれサンド	名詞	
すらっしゅからぁず	スラッシュからぁず	名詞	
すらっしゅからあず	スラッシュからぁず	名詞	
すらっしゅからーず	スラッシュからぁず	名詞	
ぐるぐるりぼん	ぐるぐるリボン	名詞	
はなまるーぷ	はなまLOOP	名詞	
くらっしゅえくれーる	クラッシュえくれぇる	名詞	
すぴんとるねーど	スピンとるね〜ど	名詞	
のわーるすふぃあ	のわーるスフィア	名詞	
ふりっぷぶらし	ふりっぷブラシ	名詞	
もえさかりぼん	もえさかリボン	名詞	
ぷりんせすおぶまーめいど	プリンセスオブマーメイド	名詞	TOH ベリルが使用
くうはそうりゅうしょう	空破双龍掌	名詞	
まじんれんざん	魔神連斬	名詞	
こうりゅうがれん	咬龍牙連	名詞	
がりゅうめっしょうせん	餓龍滅衝旋	名詞	
がりゅうめつしょうせん	餓龍滅衝旋	名詞	
くうはせんめいだん	空破穿命弾	名詞	
せんくうきょうえいじん	穿空鏡影陣	名詞	
じゃりゅうこうが	蛇龍交牙	名詞	
じゃえいれっしゅうがく	蛇影裂襲顎	名詞	
じゃえいれつしゅうがく	蛇影裂襲顎	名詞	
まくうが	魔空牙	名詞	
しゅんえいさつ	瞬影刹	名詞	
しりゅうせんえいざん	刺龍穿影斬	名詞	
ましょうじん	魔瘴刃	名詞	
はきょうせん	破鏡閃	名詞	
はきょうそうせん	破鏡双閃	名詞	
しゅんえいじん	瞬影刃	名詞	
せんぷうれつざん	旋風裂斬	名詞	
せんぷうくうれつざん	旋風空裂斬	名詞	
はきょうふうません	破鏡封魔閃	名詞	
しゅらえんごくさつ	修羅閻獄殺	名詞	
せんらいが	穿雷牙	名詞	
こうおうてんく	光凰天駆	名詞	
ちどりしぶき	千鳥飛沫	名詞	
せんえんれっぱじん	閃闇裂破刃	名詞	
せんえんれつはじん	閃闇裂破刃	名詞	
おーらにっくすぴん	お〜らにっくスピン	名詞	
すぽいる・うぇぽん	スポイル・ウェポン	名詞	
すぽいるうぇぽん	スポイル・ウェポン	名詞	
すぽいる・あーまー	スポイル・アーマー	名詞	
すぽいるあーまー	スポイル・アーマー	名詞	
すぽいる・まいんど	スポイル・マインド	名詞	
すぽいるまいんど	スポイル・マインド	名詞	
すぽいる・れじすと	スポイル・レジスト	名詞	
すぽいるれじすと	スポイル・レジスト	名詞	
ひそうじん	飛蒼刃	名詞	
こうよくざん	光翼斬	名詞	
れっしょうよく	裂翔翼	名詞	
れつしょうよく	裂翔翼	名詞	
せいかざんしょうく	征禍斬翔駆	名詞	
とうまれっそうよく	討魔烈蒼翼	名詞	
とうまれつそうよく	討魔烈蒼翼	名詞	
れっせいじゅうじしょう	烈星十字翔	名詞	
れつせいじゅうじしょう	烈星十字翔	名詞	
れんじんしょう	連刃翔	名詞	
しゅうついざん	襲墜斬	名詞	
らいこうせん	雷光閃	名詞	
てんりゅうそう	天流槍	名詞	
ふうしんれつ	封針烈	名詞	
てんしょうざんこうけん	天翔残光剣	名詞	
こうようてんしょうく	光鷹天翔駆	名詞	
むげんひしょうざん	霧幻飛翔斬	名詞	
そうがてんりゅうそう	双牙天流槍	名詞	
げんまめつがじん	幻魔滅牙刃	名詞	
そうはくうれつざん	蒼破空裂斬	名詞	
れんじんしゅうついざん	連刃襲墜斬	名詞	
じゃっかせんそうけん	邪禍殲葬剣	名詞	
じゃかせんそうけん	邪禍殲葬剣	名詞	
ようしょうてんおうざん	遥翔天凰斬	名詞	
めっさいごうとつ	滅砕剛突	名詞	
めつさいごうとつ	滅砕剛突	名詞	
ろうこくさざめ	狼哭沙雨	名詞	
とうはぜっしょうじん	闘覇絶衝刃	名詞	
とうはぜつしょうじん	闘覇絶衝刃	名詞	
しょうそうのかた	昇爪ノ型	名詞	
ようびのかた	踊尾ノ型	名詞	
ようおのかた	踊尾ノ型	名詞	ヨウビノカタ
ばっかくのかた	爆角ノ型	名詞	
ばくかくのかた	爆角ノ型	名詞	
さいがのかた	砕牙ノ型	名詞	
ごうがくのかた	濠咢ノ型	名詞	
しゅんじんけん	瞬迅拳	名詞	
そうがだん	双牙断	名詞	
こほうせん	虎咆穿	名詞	
そうえんじん	双炎刃	名詞	
あぶそーぶ・れいう゛ん	アブソーブ・レイヴン	名詞	
あぶそーぶ・れいゔん	アブソーブ・レイヴン	名詞	
あぶそーぶ・れいぶん	アブソーブ・レイヴン	名詞	
あぶそーぶれいう゛ん	アブソーブ・レイヴン	名詞	
あぶそーぶれいゔん	アブソーブ・レイヴン	名詞	
あぶそーぶれいぶん	アブソーブ・レイヴン	名詞	
からみてぃ・はうんど	カラミティ・ハウンド	名詞	
からみてぃはうんど	カラミティ・ハウンド	名詞	
すらっしゅ・じゃがー	スラッシュ・ジャガー	名詞	
すらっしゅじゃがー	スラッシュ・ジャガー	名詞	
すぱいらる・ほーく	スパイラル・ホーク	名詞	
すぱいらるほーく	スパイラル・ホーク	名詞	
ぐらうんど・もーる	グラウンド・モール	名詞	
ぐらうんどもーる	グラウンド・モール	名詞	
くりむぞん・らいの	クリムゾン・ライノ	名詞	
くりむぞんらいの	クリムゾン・ライノ	名詞	
てんぺすと・すねいく	テンペスト・スネイク	名詞	
てんぺすとすねいく	テンペスト・スネイク	名詞	
めてお・どれいく	メテオ・ドレイク	名詞	
めておどれいく	メテオ・ドレイク	名詞	
せんらんかそうのかた	旋嵐火爪ノ型	名詞	
りんおうてんしょうく	鱗凰天翔駆	名詞	
てんこうじんらいくうれつしょう	天光神雷空裂衝	名詞	
せいかせいえいそうがじん	征禍星影双牙刃	名詞	
おうかせきれい・つづみぼし	桜花鶺鴒・鼓星	名詞	
おうかせきれいつづみぼし	桜花鶺鴒・鼓星	名詞	
おうかせきれい	桜花鶺鴒・鼓星	名詞	オウカセキレイ・ツヅミボシ
そうこうのわるつ	蒼紅円舞曲	名詞	
そうこうえんぶきょく	蒼紅円舞曲	名詞	ソウコウノワルツ
めいあんれんごくらせつせん	冥闇煉獄羅刹閃	名詞	
こらんりゅうせいおとし	コラン流星落し	名詞	
こらんりゅうせいおとし	コラン流星落とし	名詞	
くろむのまけん	クロムの魔剣	名詞	
かわらわりそうしょう	瓦割り槍掌	名詞	
こじゅう	虎銃	名詞	
ごうだん	轟弾	名詞	
ひょうりゅうだん	雹龍弾	名詞	
りゅうほう	龍砲	名詞	
びゃっこほう	白虎砲	名詞	
たいこのめんじん	太鼓の面人	名詞	
ろーぜ・しゅたっへる	ローゼ・シュタッヘル	名詞	
ろーぜしゅたっへる	ローゼ・シュタッヘル	名詞	
とぅわいん・えんで	トゥワイン・エンデ	名詞	
とぅわいんえんで	トゥワイン・エンデ	名詞	
かろす・いでぃあ	カロス・イディア	名詞	
かろすいでぃあ	カロス・イディア	名詞	
ようびなろーず	妖美なローズ	名詞	
ごうかけんらんぼんばー	豪華絢爛ボンバー	名詞	
みわくのはりけーん	魅惑のハリケーン	名詞	
ふうじんせんぶ	風塵旋舞	名詞	
しゅんじんれっぱ	瞬刃裂破	名詞	
しゅんじんれつは	瞬刃裂破	名詞	
らむ・おんぶる	ラム・オンブル	名詞	
らむおんぶる	ラム・オンブル	名詞	
るなえ・うむぶら	ルナエ・ウムブラ	名詞	
るなえうむぶら	ルナエ・ウムブラ	名詞	
ふぃーにす・おりごー	フィーニス・オリゴー	名詞	
ふぃーにすおりごー	フィーニス・オリゴー	名詞	
そりす・らでぃうす	ソリス・ラディウス	名詞	
そりすらでぃうす	ソリス・ラディウス	名詞	
さとぅるに・てっら	サトゥルニ・テッラ	名詞	
さとぅるにてっら	サトゥルニ・テッラ	名詞	
ひおうさいろうじん	緋王砕楼刃	名詞	
そうこうばんしょうけん	想煌絆翔剣	名詞	TOH 没技
ひおう	緋凰	名詞	TOH 没技
とうまごうそうは	倒魔剛想波	名詞	TOH 没技
やてんしょうおうせん	夜天翔桜旋	名詞	TOH 没技
ほむらみみずく	焔木菟	名詞	TOH 没技
きょうだいにんきょうげり	兄妹任侠蹴り	名詞	TOH 没技
ひょうげつほうりん	氷月泡輪	名詞	TOH 没技
おとめめったげり	乙女メッタ蹴り	名詞	TOH 没技
ごーとぅへぶん	GO to へぶん	名詞	TOH 没技
ごうとぅへぶん	GO to へぶん	名詞	TOH 没技
ごーとぅーへぶん	GO to へぶん	名詞	TOH 没技
ごうとぅーへぶん	GO to へぶん	名詞	TOH 没技
めでぃかるーぷ	めでぃかLOOP	名詞	TOH 没技
やきいれこんぼ	ヤキ入れコンボ	名詞	TOH 没技
びゅーてぃはりけーん	ビューティはりけーん	名詞	TOH 没技
でふれすぱいらる	でふれスパイラル	名詞	TOH 没技
せんおうか	旋桜花	名詞	
おうがばくさいざん	桜牙爆砕斬	名詞	
ししてんこうだん	獅子天吼弾	名詞	
あんちぇいんど・のーと	アンチェインド・ノート	名詞	
あんちぇいんどのーと	アンチェインド・ノート	名詞	
あいてむなぞつかってんじゃねぇ	ア イ テ ム な ぞ 使 っ て ん じ ゃ ね ぇ ！	名詞	マイソロ2、3 バルバトスが使用
あいてむなぞつかってんじゃねえ	ア イ テ ム な ぞ 使 っ て ん じ ゃ ね ぇ ！	名詞	マイソロ2、3 バルバトスが使用
あいてむなぞ	ア イ テ ム な ぞ 使 っ て ん じ ゃ ね ぇ ！	名詞	マイソロ2、3 バルバトスが使用
らくよう	落葉	名詞	
ししれんとうだ	獅子連濤打	名詞	
ばれっとおぶふぉーす	バレット オブ フォース	名詞	
きょようげんかい	許容限界	名詞	
きょようげんかい	許容限界〜サマヨエルタマシイ〜	名詞	
きょようげんかいさまよえるたましい	許容限界〜サマヨエルタマシイ〜	名詞	
さまよえるたましい	許容限界〜サマヨエルタマシイ〜	名詞	
ぜったいふかしんのりょういき	絶対不可侵の領域	名詞	
ぜったいふかしんのりょういき	絶対不可侵の領域-ブツリムコウ-	名詞	
ぜったいふかしんのりょういきぶつりむこう	絶対不可侵の領域-ブツリムコウ-	名詞	
ぜったいふかしんのりょういき	絶対不可侵の領域-ジュツムコウ-	名詞	
ぜったいふかしんのりょういきじゅつむこう	絶対不可侵の領域-ジュツムコウ-	名詞	
きょうき	叫機-コドクヘノカツボウ-	名詞	
きょうきこどくへのかつぼう	叫機-コドクヘノカツボウ-	名詞	
こどくへのかつぼう	叫機-コドクヘノカツボウ-	名詞	
きょうき	狂機 -セカイヘノゼツボウ-	名詞	
きょうきせかいへのぜつぼう	狂機 -セカイヘノゼツボウ-	名詞	
せかいへのぜつぼう	狂機 -セカイヘノゼツボウ-	名詞	
かむい	神威	名詞	
しんだおすれーざー	真ダオスレーザー	名詞	
えたーなるりかーらんす	エターナルリカーランス	名詞	TOVS リヒターが使用
しゅんとつ	瞬突	名詞	
そうしょう	双衝	名詞	
そうじん	葬刃	名詞	
せんしんきゃく	潜身脚	名詞	
れっしんこほう	裂震虎砲	名詞	ToG アスベルが使用
れつしんこほう	裂震虎砲	名詞	ToG アスベルが使用
ばっさいりゅうざん	抜砕竜斬	名詞	
ばつとうりゅうざん	抜砕竜斬	名詞	
ふうよくしょう	封翼衝	名詞	ホウヨクショウ
ほうよくしょう	封翼衝	名詞	
せんろうが	旋狼牙	名詞	
しそうてんげん	四葬天幻	名詞	
すいえいしん	水影身	名詞	
さいじんれいが	砕陣霊臥	名詞	
らいざんしょう	雷斬衝	名詞	
しょうおうしん	衝皇震	名詞	
しょうこうしん	衝皇震	名詞	ショウオウシン
さいひょうじん	砕氷刃	名詞	
おぼろづきよ	朧月夜	名詞	
おぼろつきよ	朧月夜	名詞	
れっかいおう	裂壊桜	名詞	
れつかいおう	裂壊桜	名詞	
じゃれいいっせん	邪霊一閃	名詞	
ほうらいさつ	崩雷殺	名詞	
ふうがぜっこう	風牙絶咬	名詞	
ふうがぜつこう	風牙絶咬	名詞	
めいざんぷう	冥斬封	名詞	
めいざんふう	冥斬封	名詞	メイザンプウ
しでんめってんしょう	紫電滅天翔	名詞	
しでんめつてんしょう	紫電滅天翔	名詞	
ふうじんじゃっか	封神雀華	名詞	
ふうじんじゃくか	封神雀華	名詞	
きょっこうれんげ	極光蓮華	名詞	
しょうりゅうひょうぶ	昇竜氷舞	名詞	
かっしんこうは	活心鋼破	名詞	
かつしんこうは	活心鋼破	名詞	
じゅうはごうしょうざん	獣破轟衝斬	名詞	
びゃくやせんめつけん	白夜殲滅剣	名詞	
はくやせんめつけん	白夜殲滅剣	名詞	ビャクヤセンメツケン
ざんくうじんむじんしょう	斬空刃無塵衝	名詞	
ざんくうじん	斬空刃	名詞	
むじんしょう	無塵衝	名詞	
てんはじんらいだん	天覇神雷断	名詞	
てんぱじんらいだん	天覇神雷断	名詞	
とうき	刀輝	名詞	
さざん	三散	名詞	
そうげつ	双月	名詞	
せんこう	穿光	名詞	ToG ソフィが使用
せっぱしょう	刹破衝	名詞	
せつはしょう	刹破衝	名詞	
れんきごうしゅく	錬気轟縮	名詞	
じんれいせん	仁麗閃	名詞	
れいししょうだん	霊子障断	名詞	
れっこうざんめつ	烈孔斬滅	名詞	
れつこうざんめつ	烈孔斬滅	名詞	
そうりゅうきゃく	双竜脚	名詞	
せんげんぶ	旋幻舞	名詞	
こうよくてんしょう	光翼天翔	名詞	
ぜろ・でぃぞるう゛ぁー	ゼロ・ディゾルヴァー	名詞	
ぜろでぃぞるう゛ぁー	ゼロ・ディゾルヴァー	名詞	
ぜろ・でぃぞるゔぁー	ゼロ・ディゾルヴァー	名詞	
ぜろでぃぞるゔぁー	ゼロ・ディゾルヴァー	名詞	
しゃどう・もーめんと	シャドウ・モーメント	名詞	
しゃどうもーめんと	シャドウ・モーメント	名詞	
じょうしん	浄心	名詞	
せいじゅん	清潤	名詞	
れいき	霊貴	名詞	
さーぺんと	水蛇刀	名詞	
すいじゃとう	水蛇刀	名詞	サーペント
みずへびとう	水蛇刀	名詞	サーペント
みずへびかたな	水蛇刀	名詞	サーペント
さーぺんと	サーペント	名詞	
れくいえむ	鎮魂閃	名詞	
ちんこんせん	鎮魂閃	名詞	レクイエム
れくいえむ	レクイエム	名詞	
いんふぃにっと	無限刀	名詞	
むげんとう	無限刀	名詞	インフィニット
いんふぃにっと	インフィニット	名詞	
はーべすと	草薙刃	名詞	
くさなぎじん	草薙刃	名詞	ハーベスト
はーべすと	ハーベスト	名詞	
さんだーぼると	神雷招	名詞	
じんらいしょう	神雷招	名詞	サンダーボルト
しんらいしょう	神雷招	名詞	サンダーボルト
さんだーぼると	サンダーボルト	名詞	
ふりーずれいん	凍驟雨	名詞	
とうしゅうう	凍驟雨	名詞	フリーズレイン
ふぉれすと	四霊陣	名詞	
しれいじん	四霊陣	名詞	フォレスト
ふぉれすと	フォレスト	名詞	
あすてりずむらいん	アステリズム・ライン	名詞	
あすてりずむ・らいん	アステリズム・ライン	名詞	
いのせんと・がーでん	イノセント・ガーデン	名詞	ToG シェリアが使用
いのせんとがーでん	イノセント・ガーデン	名詞	ToG シェリアが使用
とりりおん・どらいぶ	トリリオン・ドライブ	名詞	
とりりおんどらいぶ	トリリオン・ドライブ	名詞	
こげつ	弧月	名詞	
しんげつ	新月	名詞	
みづき	深月	名詞	
りゅうせい	流星	名詞	
ほうばっか	崩爆華	名詞	
ほうばくか	崩爆華	名詞	
ざんぷうが	斬風牙	名詞	
ざんふうが	斬風牙	名詞	ザンプウガ
そうじんけん	双塵剣	名詞	
そうげんらんぶ	双幻乱舞	名詞	
だんらいが	断雷牙	名詞	
せんぷうれっく	旋風裂駆	名詞	
せんぷうれつく	旋風裂駆	名詞	
らいがしょうらい	雷牙招来	名詞	
ろーりんぐさんだーぼると	R.サンダーボルト	名詞	
rさんだーぼると	R.サンダーボルト	名詞	
あーるさんだーぼると	R.サンダーボルト	名詞	
あーる。さんだーぼると	R.サンダーボルト	名詞	
あんすたんう゛ぁるす	アンスタンヴァルス	名詞	
あんすたんゔぁるす	アンスタンヴァルス	名詞	
あんすたんばるす	アンスタンヴァルス	名詞	
らんう゛ぇるす・れぞん	ランヴェルス・レゾン	名詞	
らんう゛ぇるすれぞん	ランヴェルス・レゾン	名詞	
らんゔぇるす・れぞん	ランヴェルス・レゾン	名詞	
らんゔぇるすれぞん	ランヴェルス・レゾン	名詞	
らんべるす・れぞん	ランヴェルス・レゾン	名詞	
らんべるすれぞん	ランヴェルス・レゾン	名詞	
いっしん	壱心	名詞	
にりつ	弐律	名詞	
りにつ	弐律	名詞	ToG体験版の誤植
さんがい	参界	名詞	
しもん	四紋	名詞	
ろーるふれあ	旋の炎	名詞	
せんのほのお	旋の炎	名詞	ロールフレア
こらぷしょん	落凰破	名詞	
らくおうは	落凰破	名詞	コラプション
そにっくばすたー	疾風怒濤	名詞	
しっぷうどとう	疾風怒濤	名詞	ソニックバスター
だーくねす	漆の玄	名詞	
うるしのくろ	漆の玄	名詞	ダークネス
しつのげん	漆の玄	名詞	ダークネス
りぞるう゛ぁー	守破離	名詞	
りぞるゔぁー	守破離	名詞	
しゅはり	守破離	名詞	リゾルヴァー
ぐらんどばーすと	驚天動地	名詞	
きょうてんどうち	驚天動地	名詞	グランドバースト
れ・でぃすらぷしょん	レ・ディスラプション	名詞	
れでぃすらぷしょん	レ・ディスラプション	名詞	
からみてぃ・ろんど	カラミティ・ロンド	名詞	
からみてぃろんど	カラミティ・ロンド	名詞	
えたーなる・せれなーで	エターナル・セレナーデ	名詞	
えたーなるせれなーで	エターナル・セレナーデ	名詞	
るてん	流転	名詞	
きせん	輝線	名詞	
せいさん	星散	名詞	
びゃっか	百華	名詞	
ひゃっか	百華	名詞	ビャッカ
ふりーじんぐ	氷霧の白薙	名詞	
ひょうむのしらなぎ	氷霧の白薙	名詞	フリージング
がとりんぐいびる	悪運の連鎖	名詞	ToG パスカルが使用
あくうんのれんさ	悪運の連鎖	名詞	ガトリングイビル
ぶれいくしゅーと	星屑の破者	名詞	ToG パスカルが使用
ほしくずのはしゃ	星屑の破者	名詞	ブレイクシュート
ほーくねいる	夜鷹の爪跡	名詞	
よだかのつめあと	夜鷹の爪跡	名詞	ホークネイル
よたかのつめあと	夜鷹の爪跡	名詞	ホークネイル
よるたかのつめあと	夜鷹の爪跡	名詞	ホークネイル
やおうのつめあと	夜鷹の爪跡	名詞	ホークネイル
さどんいんぱくと	突然の衝撃	名詞	
とつぜんのしょうげき	突然の衝撃	名詞	サドンインパクト
ある・ふぃーね	終焉の宣告	名詞	
あるふぃーね	終焉の宣告	名詞	
しゅうえんのせんこく	終焉の宣告	名詞	アル・フィーネ
ふらっくすふぉーむ	音速の導師	名詞	
おんそくのどうし	音速の導師	名詞	フラックスフォーム
ぐりむしるふぃ・そーどくろす	G・ソードクロス	名詞	
ぐりむしるふぃそーどくろす	G・ソードクロス	名詞	
じーそーどくろす	G・ソードクロス	名詞	グリムシルフィ・ソードクロス
じー・そーどくろす	G・ソードクロス	名詞	グリムシルフィ・ソードクロス
gそーどくろす	G・ソードクロス	名詞	グリムシルフィ・ソードクロス
Gそーどくろす	G・ソードクロス	名詞	グリムシルフィ・ソードクロス
ぐりむしるふぃ・そーどくろす	グリムシルフィ・ソードクロス	名詞	
ぐりむしるふぃそーどくろす	グリムシルフィ・ソードクロス	名詞	
しあんでぃーむ・えくしーど	S・エクシード	名詞	
しあんでぃーむえくしーど	S・エクシード	名詞	
えすえくしーど	S・エクシード	名詞	シアンディーム・エクシード
えす・えくしーど	S・エクシード	名詞	シアンディーム・エクシード
sえくしーど	S・エクシード	名詞	シアンディーム・エクシード
Sえくしーど	S・エクシード	名詞	シアンディーム・エクシード
しあんでぃーむ・えくしーど	シアンディーム・エクシード	名詞	
しあんでぃーむえくしーど	シアンディーム・エクシード	名詞	
ぶらどふらんむ・あさると	B・アサルト	名詞	
ぶらどふらんむあさると	B・アサルト	名詞	
びーあさると	B・アサルト	名詞	ブラドフランム・アサルト
びー・あさると	B・アサルト	名詞	ブラドフランム・アサルト
b・あさると	B・アサルト	名詞	ブラドフランム・アサルト
S・あさると	B・アサルト	名詞	ブラドフランム・アサルト
ぶらどふらんむ・あさると	ブラドフランム・アサルト	名詞	
ぶらどふらんむあさると	ブラドフランム・アサルト	名詞	
かんげん	甘言	名詞	
ひれい	非礼	名詞	
せっぱ	説破	名詞	
ぐろう	愚弄	名詞	
う゛ぁーてくす・ろーず	ヴァーテクス・ローズ	名詞	
う゛ぁーてくすろーず	ヴァーテクス・ローズ	名詞	
ゔぁーてくす・ろーず	ヴァーテクス・ローズ	名詞	
ゔぁーてくすろーず	ヴァーテクス・ローズ	名詞	
ぶらっでぃ・ろーず	ブラッディ・ローズ	名詞	ToG リチャードが使用
ぶらっでぃろーず	ブラッディ・ローズ	名詞	ToG リチャードが使用
まじぇすてぃ・げいと	マジェスティ・ゲイト	名詞	
まじぇすてぃげいと	マジェスティ・ゲイト	名詞	
ひおうでんろうじん	緋王電楼刃	名詞	
やあっ	やあっ	名詞	
やあ	やあっ	名詞	
たあたあっ	たあたあっ	名詞	
たあたあ	たあたあっ	名詞	
えいっ	えいっ	名詞	
えい	えいっ	名詞	
てやてやっ	てやてやっ	名詞	
てやてや	てやてやっ	名詞	
じんせつ	迅節	名詞	
ずいい	随意	名詞	
まおうばくえんは	魔王爆焔破	名詞	
あくまじゅうそう	悪魔銃槍	名詞	デモンガンス
でもんがんす	悪魔銃槍	名詞	
かねはいのちよりおもいっす	金は命より重いっす	名詞	
かねはいのちより	金は命より重いっす	名詞	
でぃう゛ぃにてぃ・うぃあーど	ディヴィニティ・ウィアード	名詞	
でぃう゛ぃにてぃうぃあーど	ディヴィニティ・ウィアード	名詞	
でぃゔぃにてぃ・うぃあーど	ディヴィニティ・ウィアード	名詞	
でぃゔぃにてぃうぃあーど	ディヴィニティ・ウィアード	名詞	
せるしうすきゃりばー	セルシウスキャリバー	名詞	ToG、マイソロ3 ヴェイグが使用
ぶるーあーす	ブルーアース	名詞	ToG秘奥義
ぴこはんっ	ピコハンッ！	名詞	
ぴこはんっ!	ピコハンッ！	名詞	
ぴこはん	ピコハンッ！	名詞	
ぼよよんかいひじゅつ	ぽよよん回避術	名詞	
まるのみふぁいあ	まるのみファイア	名詞	
ぼよよんだんす	ぼよよんダンス	名詞	
しんらばんしょうひっぷ	森羅万象ヒップ	名詞	
えんせんが	燕閃牙	名詞	なりダンX ロディが使用
こうてんしっく	虹天疾駆	名詞	
こうてんしつく	虹天疾駆	名詞	
てんしょうよく	天翔翼	名詞	
つばめがえし	燕返し	名詞	
つばめがえし	連波女返し	名詞	
えんてんしん	燕転身	名詞	
ほうよくそう	封翼爪	名詞	
ふうよくそう	封翼爪	名詞	ホウヨクソウ
れんじんえんしょうけん	連塵燕翔剣	名詞	
ひえんざんくうきゃく	飛燕斬空脚	名詞	
れんぱじょうてん	連波女雨纏	名詞	
つばめうてん	連波女雨纏	名詞	レンパジョウテン
ひれんせん	飛連閃	名詞	
とりゅう	屠竜	名詞	なりダンX チェスターが使用
てんいじょうはきゅう	天威浄破弓	名詞	
らいじんじゅうれんげき	雷迅獣連撃	名詞	なりダンX すずが使用
そうきゅうれんしょうは	双咎連翔破	名詞	
ちりしぐれ	散時雨	名詞	
らんこ・こうはしゅう	乱虎・光破襲	名詞	
らんここうはしゅう	乱虎・光破襲	名詞	
かげつれんざん	霞月連斬	名詞	
かげつれんざん・てん	霞月連斬・天	名詞	
かげつれんざんてん	霞月連斬・天	名詞	
かいれんじん	海蓮刃	名詞	なりダンX ディオが使用
ろうえいが	狼影牙	名詞	
ろうえいが・てん	狼影牙・天	名詞	
ろうえいがてん	狼影牙・天	名詞	
ろうえい・てっさいが	狼影・鉄砕牙	名詞	
ろうえいてっさいが	狼影・鉄砕牙	名詞	
なりきりくろすすらっしゅ	なりきりXスラッシュ	名詞	
なりきりxすらっしゅ	なりきりXスラッシュ	名詞	
なりきりばつすらっしゅ	なりきりXスラッシュ	名詞	
やりすぎくろすおーばー	やりすぎXオーバー	名詞	
やりすぎxおーばー	やりすぎXオーバー	名詞	
やりすぎばつおーばー	やりすぎXオーバー	名詞	
じゅうは・そうがしょう	獣破・双牙衝	名詞	
じゅうはそうがしょう	獣破・双牙衝	名詞	
しゅうそう・れんげつざん	襲爪・連月斬	名詞	
しゅうそうれんげつざん	襲爪・連月斬	名詞	
かいれんじん・しぐれ	海蓮刃・時雨	名詞	
かいれんじんしぐれ	海蓮刃・時雨	名詞	
かげつこうおうせん	霞月光桜閃	名詞	
ひょうろうらんが	氷狼乱牙	名詞	
てんくじょうそうじん	天駆澄想刃	名詞	
こうはじん	紅破刃	名詞	なりダンX ディオが使用
こらんしゅう	虎乱襲	名詞	なりダンX ディオが使用
くうしょうれっぷう	空翔烈風	名詞	なりダンX ディオが使用
ばっとうざん	抜刀斬	名詞	
しんくうはざん・てん	真空破斬・天	名詞	
しんくうはざんてん	真空破斬・天	名詞	
げんえいしょうく	幻影翔駆	名詞	
げんえい・こうはだん	幻影・紅破弾	名詞	
げんえいこうはだん	幻影・紅破弾	名詞	
くうしょう・れつざんは	空翔・裂斬破	名詞	
くうしょうれつざんは	空翔・裂斬破	名詞	
あきさざめ・ひとひら	秋沙雨・一閃	名詞	
あきさざめひとひら	秋沙雨・一閃	名詞	
あきさざめ・いっせん	秋沙雨・一閃	名詞	アキサザメ・ヒトヒラ
あきさざめいっせん	秋沙雨・一閃	名詞	アキサザメ・ヒトヒラ
くうがせいこん	空牙聖痕	名詞	
ちりひさめ	散氷雨	名詞	
ひげつしょうせん	氷月翔閃	名詞	なりダンX メルが使用
ふうじんれっしょう	風迅裂昇	名詞	
せんこう・ひょうそうじん	閃煌・氷槍陣	名詞	
せんこうひょうそうじん	閃煌・氷槍陣	名詞	
ふうじんせんぴょうしん	風迅穿氷針	名詞	
れっしんてんしょう	裂震天衝	名詞	なりダンX メルが使用
らいじんそうしょう	雷神双招	名詞	
ましょうへき	魔障壁	名詞	
ぐれんしゅう	紅蓮襲	名詞	
りゅうえいざん	流影斬	名詞	
らいこうりん	雷煌鈴	名詞	
らいこうりん・かい	雷煌鈴・解	名詞	
らいこうりんかい	雷煌鈴・解	名詞	
まじんめっしょうかく	魔神滅招角	名詞	
まじんめつしょうかく	魔神滅招角	名詞	
ばく・まじんけん	爆・魔神剣	名詞	
ばくまじんけん	爆・魔神剣	名詞	
どりゅうしょう	土竜衝	名詞	
もぐらしょう	土竜衝	名詞	ドリュウショウ
ぐれんじん	紅蓮刃	名詞	
ちじんしょう	地塵招	名詞	
ちじんせんこう	地塵穿甲	名詞	
てんらいげき	天雷撃	名詞	
ごうえんだ	轟炎打	名詞	
どりゅうしょう・ごうけん	土竜衝・剛剣	名詞	
どりゅうしょうごうけん	土竜衝・剛剣	名詞	
てんらいこほう	天雷虎吼	名詞	
てんらいここう	天雷虎吼	名詞	テンライコホウ
れっぷうばくらいじん	烈風爆雷陣	名詞	
しゅん・こうたいそう	瞬・鋼体装	名詞	
しゅんこうたいそう	瞬・鋼体装	名詞	
ひょうこうが	氷煌牙	名詞	
だんくうそう	断空槍	名詞	
がりゅうめっせん	臥竜滅閃	名詞	
めっすいそう	滅水槍	名詞	
めつすいそう	滅水槍	名詞	
れっくせん・けんそう	裂駆閃・堅装	名詞	
れっくせんけんそう	裂駆閃・堅装	名詞	
れつくせん・けんそう	裂駆閃・堅装	名詞	
れつくせんけんそう	裂駆閃・堅装	名詞	
ひょうばくせんぷうが	氷爆旋風牙	名詞	
しゅん・きょうめいへき	瞬・共鳴壁	名詞	
しゅんきょうめいへき	瞬・共鳴壁	名詞	
けんしょうらい	堅招来	名詞	
こうけん	鋼拳	名詞	
れっこうじゅうけん	烈鋼重拳	名詞	
しょうか	衝華	名詞	
しょうかむさん	衝華無散	名詞	
はこう	破甲	名詞	
らんきこう	嵐鬼甲	名詞	
てんぱしょう	天破掌	名詞	
てんはしょう	天破掌	名詞	テンパショウ
れんきほう	練気砲	名詞	
れっこう・じゅうがだん	烈鋼・重牙弾	名詞	
れっこうじゅうがだん	烈鋼・重牙弾	名詞	
れつこう・じゅうがだん	烈鋼・重牙弾	名詞	
れつこうじゅうがだん	烈鋼・重牙弾	名詞	
ふりゅう	浮流	名詞	
ふりゅうついげつせん	浮流追月閃	名詞	
しゃくがんけん	灼岩拳	名詞	
まじん・しょうらいけん	魔陣・昇雷拳	名詞	
まじんしょうらいけん	魔陣・昇雷拳	名詞	
せんきえいていだん	千鬼鋭蹄弾	名詞	
げっせんしょうげき	月旋翔撃	名詞	
おうか・れつえんしゅう	桜華・裂焔蹴	名詞	
おうかれつえんしゅう	桜華・裂焔蹴	名詞	
さんかもうしゅうきゃく	三華猛蹴脚	名詞	なりダンX メルが使用
ばくさいとるねーど	爆砕トルネード	名詞	
げきしんふるすいんぐ	激震フルスイング	名詞	
じゅうそうらんどりっぱー	蹂走ランドリッパー	名詞	
むげんごうばくきゅう	夢幻轟爆弓	名詞	
まじんめっさつだん	魔人滅殺弾	名詞	
まじんめつさつだん	魔人滅殺弾	名詞	
せいてんとうばっきゅう	聖填討伐弓	名詞	
せいてんとうばつきゅう	聖填討伐弓	名詞	
そうじゃ	走蛇	名詞	
そうだ	走蛇	名詞	ソウジャ
ぐれん・てん	紅蓮・天	名詞	
ぐれんてん	紅蓮・天	名詞	
ひりゅう	飛竜	名詞	
ひりゅうれんと	飛竜連屠	名詞	
まや	魔夜	名詞	
しゅんれつが	瞬裂牙	名詞	
ししらいこう	獅子雷吼	名詞	
がせんごうふ	牙旋豪斧	名詞	
しこうせんぶ	獅吼旋舞	名詞	
がせん・こうぶえん	牙旋・鋼舞炎	名詞	
がせんこうぶえん	牙旋・鋼舞炎	名詞	
れっくうざん・せつが	烈空斬・刹牙	名詞	
れっくうざんせつが	烈空斬・刹牙	名詞	
れつくうざん・せつが	烈空斬・刹牙	名詞	
れつくうざんせつが	烈空斬・刹牙	名詞	
えんばくせんぷうが	炎爆旋風牙	名詞	
れっぷうじんふしょう	裂風迅斧衝	名詞	
れつふうじんふしょう	裂風迅斧衝	名詞	
ごう・まにゃんけん	GO・魔猫剣	名詞	
ごうまにゃんけん	GO・魔猫剣	名詞	
ごう・まねこけん	GO・魔猫剣	名詞	GO・マニャンケン
ごうまねこけん	GO・魔猫剣	名詞	GO・マニャンケン
ごう・まびょうけん	GO・魔猫剣	名詞	GO・マニャンケン
ごうまびょうけん	GO・魔猫剣	名詞	GO・マニャンケン
まにゃんけん	魔猫剣	名詞	
まねこけん	魔猫剣	名詞	マニャンケン
まびょうけん	魔猫剣	名詞	マニャンケン
しゅんじんにゃーご	瞬刃ニャーゴ	名詞	
せつにゃ	刹ニャ	名詞	
しんくうれつにゃん	真空烈ニャン	名詞	
ひょうが	豹牙	名詞	
とびたか	鳶鷹	名詞	
むげんじん	夢幻刃	名詞	
むげんほうよう	夢幻抱擁	名詞	
かげぬい	影縫	名詞	なりダンX ディオが使用
みえいさい	御影砕	名詞	
もくとん・はがけのまい	木遁・葉翔舞	名詞	
もくとんはがけのまい	木遁・葉翔舞	名詞	
らいとん・しびれくらげ	雷遁・痺海月	名詞	
らいとんしびれくらげ	雷遁・痺海月	名詞	
かとん・ほむらとかげ	火遁・焔蜥蜴	名詞	
かとんほむらとかげ	火遁・焔蜥蜴	名詞	
すいとん・あおじし	水遁・蒼獅子	名詞	
すいとんあおじし	水遁・蒼獅子	名詞	
どとん・ありじごく	土遁・蟻地獄	名詞	
どとんありじごく	土遁・蟻地獄	名詞	
もくとん	木遁・葉翔舞	名詞	ハガケノマイ
らいとん	雷遁・痺海月	名詞	シビレクラゲ
かとん	火遁・焔蜥蜴	名詞	ホムラトカゲ
すいとん	水遁・蒼獅子	名詞	アオジシ
どとん	土遁・蟻地獄	名詞	蟻地獄
はがけのまい	葉翔舞	名詞	
しびれくらげ	痺海月	名詞	
ほむらとかげ	焔蜥蜴	名詞	
あおじし	蒼獅子	名詞	
ありじごく	蟻地獄	名詞	
えいせんしゅりけん	影閃手裏剣	名詞	
しっぷうじんらい	疾風迅雷	名詞	
あまつがえし	天ツ返	名詞	
てんつがえし	天ツ返	名詞	アマツガエシ
てんつへん	天ツ返	名詞	アマツガエシ
すねくだき	脛砕	名詞	
ごりんくだき・りほう	五輪砕・裏法	名詞	
ごりんさい・りほう	五輪砕・裏法	名詞	ゴリンクダキ・リホウ
ごりんくだきりほう	五輪砕・裏法	名詞	
ごりんさいりほう	五輪砕・裏法	名詞	ゴリンクダキ・リホウ
ごりんくだき	五輪砕	名詞	
ごりんさい	五輪砕	名詞	ゴリンクダキ
りほう	裏法	名詞	
かけあしりずむ	かけあしリズム	名詞	
ぱららぼいす	ぱららボイス	名詞	
そぷらのしゃうと	そぷらのシャウト	名詞	
ぐみらぶそんぐ	ぐみLOVEソング	名詞	
ぐみらう゛そんぐ	ぐみLOVEソング	名詞	
ぐみらゔそんぐ	ぐみLOVEソング	名詞	
ぴよはざん	ピヨ破斬	名詞	
ぼあせんこう	ボア戦吼	名詞	
ふうじんばにー	風迅バニー	名詞	
ぼあぴよはざん	ボアピヨ破斬	名詞	
ばくえんふぁいが	爆炎ファイガ	名詞	
てっきゅうましーん	鉄球マシーン	名詞	
てつきゅうましーん	鉄球マシーン	名詞	
みさいるせっち	ミサイル設置	名詞	
ばっかもうさいしゅう	爆火猛崔襲	名詞	
ばくかもうさいしゅう	爆火猛崔襲	名詞	
ふうさつれんとうしょう	封殺連涛衝	名詞	
すぷれっど・ぜろ	スプレッド・ゼロ	名詞	なりダンX メルティアが使用
さゆうなぎはらい	左右薙ぎ払い	名詞	
しっぷうそうじん	疾風双刃	名詞	
いっそうつばめがえし	一双燕返し	名詞	
いちそうつばめがえし	一双燕返し	名詞	
てんかむそういづなまい	天下無双飯綱舞い	名詞	
ついげき	追撃	名詞	
さんそうえんこん	三爪炎痕	名詞	
ころんだ	転んだ	名詞	
ころんだ	転んだ！？	名詞	
ころんだ!	転んだ！？	名詞	
ころんだ!?	転んだ！？	名詞	
はっせいれんしゅう	発声練習	名詞	
どれみれど	ドレミレド♪	名詞	
どれみれどおんぷ	ドレミレド♪	名詞	
ぱいなげ	パイ投げ	名詞	
いっしょにうたいましょ	一緒に歌いましょ♪	名詞	
いっしょにうたいましょおんぷ	一緒に歌いましょ♪	名詞	
こんさーと	コンサート	名詞	
こんさーと	コンサート♪	名詞	
こんさーとおんぷ	コンサート♪	名詞	
いんたびゅころんだ	インタビュ…転んだ	名詞	なりダンX 没技
いんたびゅーころんだ	インタビュ…転んだ	名詞	なりダンX 没技
いんたびゅてんころんだ	インタビュ…転んだ	名詞	なりダンX 没技
ころがす	転がす	名詞	
おうじだっしゅ	王子ダッシュ	名詞	
おうじだっしゅ	王子ダッシュS	名詞	
おうじだっしゅS	王子ダッシュS	名詞	
おうじだっしゅs	王子ダッシュS	名詞	
おうじだっしゅえす	王子ダッシュS	名詞	
おうじたーん	王子ターン	名詞	
かたまりだましい	塊魂	名詞	
かたまりだましい	塊魂！	名詞	
かたまりだましい!	塊魂！	名詞	
おにごろし	鬼殺し	名詞	
はくろゆうぶ	白鷺遊舞	名詞	
おにくびおとし	鬼首落とし	名詞	
りゅうしゃげり	竜車蹴り	名詞	
みそぎはらい	禊ぎ払い	名詞	
かりあししらぬい	刈脚白縫い	名詞	
かすみげり	霞蹴り	名詞	
あすかこんぼ	飛鳥コンボ	名詞	
あーつわざ	アーツ技	名詞	
しゃがみきっく	しゃがみキック	名詞	
たちきっく	たちキック	名詞	
かいきゃくきっく	開脚キック	名詞	
たちかいきゃくきっく	たち開脚キック	名詞	
ほうりゅうそうぶしょう	崩竜双武掌	名詞	
ざんまれっこうそう	斬魔裂咬装	名詞	
ざんまれつこうそう	斬魔裂咬装	名詞	
こうそくいどう・まえ	高速移動・前	名詞	
こうそくいどうまえ	高速移動・前	名詞	
きんきゅうかいひ	緊急回避	名詞	
めっさいとっこうだん	滅砕特攻弾	名詞	
めつさいとっこうだん	滅砕特攻弾	名詞	
めつさいとくこうだん	滅砕特攻弾	名詞	
いんがおうほう	因果応報	名詞	
すいじゃれんこう	水蛇連咬	名詞	
ふくつのきんにく	不屈の筋肉	名詞	
だいちのいかり	大地の怒り	名詞	
きさまらなぞ	貴様らなぞ！	名詞	
きさまらなぞ!	貴様らなぞ！	名詞	
ふぉーる・ざ・さん	フォール・ザ・サン	名詞	
ふぉーるざさん	フォール・ザ・サン	名詞	
どりーむほばー	どりーむホバー	名詞	
ぼよよんすとれーと	ぼよよんストレート	名詞	
りみったーかいじょ	りみったー解除	名詞	
おにび	鬼火	名詞	
こうよくせん	光翼閃	名詞	
こうよくだん	降翼弾	名詞	
しん・こうよくせん	真・光翼閃	名詞	
しんこうよくせん	真・光翼閃	名詞	
う゛ぉるとわざ	通・△×＃！	名詞	
う゛ぉるとわざ	××◎＃！	名詞	
う゛ぉるとわざ	◎▽Ｚ×！	名詞	
う゛ぉるとわざ	△□＃◎×▽！	名詞	
ゔぉるとわざ	通・△×＃！	名詞	
ゔぉるとわざ	××◎＃！	名詞	
ゔぉるとわざ	◎▽Ｚ×！	名詞	
ゔぉるとわざ	△□＃◎×▽！	名詞	
きじんれんげき	鬼神連撃	名詞	
あっきげきめつ	悪鬼撃滅	名詞	
おおおの・よこぎり	大斧・横斬り	名詞	
おおおの・たてぎり	大斧・縦斬り	名詞	
にだんぎり	二段斬り	名詞	
いかく	威嚇	名詞	
とびつつき	飛びつつき	名詞	
はっしゃするのら!	発射するのら！	名詞	
はっしゃするのら	発射するのら！	名詞	
ぜんいんしゅうごうなのらー	全員集合なのら〜	名詞	
ぜんいんしゅうごうなのら	全員集合なのら〜	名詞	
やみのいばら	闇の茨	名詞	
こくりゅうといき	黒竜吐息	名詞	
てんひょうしゅう	纏氷襲	名詞	
もちあげ	もちあげ	名詞	
かいてんぎり	回転斬り	名詞	
おとぎのくにへようこそ	おとぎの国へようこそ	名詞	
うしろげり	後蹴り	名詞	
なげきっす	投げキッス	名詞	
はねぱたぱら	羽ぱたぱた	名詞	
たつまき	竜巻	名詞	
かいてんほねたたき	回転骨叩き	名詞	
まふうじのこな	魔封じの粉	名詞	
ふういんばり	封印針	名詞	
かれはとばし	枯葉飛ばし	名詞	
くうれんか	空蓮華	名詞	
くうれんそうせんか	空蓮双旋華	名詞	
れんりきじん	練力陣	名詞	
れんりょくじん	練力陣	名詞	
れんごじん	練護陣	名詞	
れんめいじん	練命陣	名詞	
れんせいじん	練精陣	名詞	
ひえんれんきゃく	緋炎連脚	名詞	マイソロ3格闘家が使用
しっくうきゃく	疾空脚	名詞	
しつくうきゃく	疾空脚	名詞	
さつげきげんりゅうじん	殺撃幻竜陣	名詞	
うみのいやし	海の癒し	名詞	ウレルネルフェス
うれるねるふぇす	海の癒し	名詞	
むそうじんれつせん	無想神烈閃	名詞	
ほむらだいじゃのいん	焔大蛇の印	名詞	
ほむらだいじゃのしるし	焔大蛇の印	名詞	
ほむらのあぎと	焔大蛇の印	名詞	
たわーりんぐいんふぇるの	タワーリングインフェルノ	名詞	マイソロ3 リヒターが使用
れっしんこほう	烈震虎砲	名詞	マイソロ3 アスベルが使用
れつしんこほう	烈震虎砲	名詞	マイソロ3 アスベルが使用
いのせんとがーでん	イノセントガーデン	名詞	マイソロ3 シェリアが使用
これーるのねつしせん	コレールの熱視線	名詞	
わいきょくしたでじゃう゛ゅ	歪曲したデジャヴュ	名詞	
わいきょくしたでじゃゔゅ	歪曲したデジャヴュ	名詞	
わいきょくしたでじゃう゛	歪曲したデジャヴュ	名詞	
わいきょくしたでじゃゔ	歪曲したデジャヴュ	名詞	
わいきょくしたでじゃぶ	歪曲したデジャヴュ	名詞	
せきかのまりす	石化のマリス	名詞	
ぼうぎゃくなるえんう゛ぃ	暴虐なるエンヴィ	名詞	
ぼうぎゃくなるえんゔぃ	暴虐なるエンヴィ	名詞	
ぼうぎゃくなるえんびぃ	暴虐なるエンヴィ	名詞	
しせんじょうのみぜる	死線上のミゼル	名詞	
せかいのおきて	世界の掟	名詞	
かつぼうのいである	渇望のイデアル	名詞	
そくばくのそりちゅーど	束縛のソリチュード	名詞	
ついじゅうするらんきゅぬ	追従するランキュヌ	名詞	
らせんするめじゃびゅ	螺旋するメジャビュ	名詞	
らせんするめじゃう゛ゅ	螺旋するメジャビュ	名詞	
らせんするめじゃゔゅ	螺旋するメジャビュ	名詞	
らせんするめじゃゔ	螺旋するメジャビュ	名詞	
らせんするめじゃぶ	螺旋するメジャビュ	名詞	
つきあげるえーぬ	突き上げるエーヌ	名詞	
さいたんのぴてぃえ	再誕のピティエ	名詞	
せかいそうぞうのめると	世界創造のメルト	名詞	
ようそうれんげき	鷹爪連撃	名詞	
ほうじゅうきゃく	崩獣脚	名詞	
じゅうはとっこうだん	獣破特攻弾	名詞	
じゅうはとくこうだん	獣破特攻弾	名詞	
じゅうじんしょう	獣迅翔	名詞	マイソロ3 モルモが使用
らいじんじゅうれんげき	雷神獣連撃	名詞	マイソロ3 モルモが使用
じゅうえいかいき	獣影回帰	名詞	
あいぼうのものはおいらのもの	相棒のモノはオイラのモノ	名詞	
あいぼうのもの	相棒のモノはオイラのモノ	名詞	
かいきこう	快気孔	名詞	TOX ジュードが使用
れっぷうけん	烈風拳	名詞	
むえいしょう	無影掌	名詞	TOX ジュードが使用
てんほう	転泡	名詞	
はんようじん	叛陽陣	名詞	
ほうついけん	鳳墜拳	名詞	
かんくうせん	巻空旋	名詞	
せんが	尖牙	名詞	
がろうほうこ	臥狼咆虎	名詞	
しょうはまじんけん	衝波魔神拳	名詞	
れんきちゆこう	連気治癒功	名詞	TOX ジュードが使用
ばにっしゅう゛ぉると	バニッシュヴォルト	名詞	
ばにっしゅゔぉると	バニッシュヴォルト	名詞	
う゛ぁにっしゅう゛ぉると	バニッシュヴォルト	名詞	
ゔぁにっしゅゔぉると	バニッシュヴォルト	名詞	
う゛ぁにっしゅぼると	バニッシュヴォルト	名詞	
ゔぁにっしゅぼると	バニッシュヴォルト	名詞	
ばにっしゅぼると	バニッシュヴォルト	名詞	
ぱーてぃくる・ろんど	パーティクル・ロンド	名詞	
ぱーてぃくるろんど	パーティクル・ロンド	名詞	
でぃすとーるのう゛ぁ	ディストールノヴァ	名詞	
でぃすとーるのゔぁ	ディストールノヴァ	名詞	
でぃすとーるのば	ディストールノヴァ	名詞	
おーばーどらいう゛	オーバードライヴ	名詞	
おーばーどらいぶ	オーバードライヴ	名詞	
おーばーどらいゔ	オーバードライヴ	名詞	
しゅんじんけん・ほうが	瞬迅剣・砲牙	名詞	
しゅんじんけんほうが	瞬迅剣・砲牙	名詞	
しゅごほうついじん	守護砲追陣	名詞	
しんげつせん	真月閃	名詞	
しんげつそうせん	真月掃閃	名詞	
ちりゅうせん	地竜閃	名詞	
ちりゅうせんぱ	地竜閃覇	名詞	
ちりゅうせんは	地竜閃覇	名詞	
ほうりゅうれんがざん	砲竜連牙斬	名詞	
まじゅうせんこうだん	魔銃閃光断	名詞	
まじんばくえんざん	魔神爆炎斬	名詞	
まじゅうばくえんざん	魔銃爆炎斬	名詞	
がりゅうぐれんけん	我流紅蓮剣	名詞	
しぇる・う゛ぁんがーど	シェル・ヴァンガード	名詞	
しぇるう゛ぁんがーど	シェル・ヴァンガード	名詞	
しぇる・ゔぁんがーど	シェル・ヴァンガード	名詞	
しぇるゔぁんがーど	シェル・ヴァンガード	名詞	
しぇる・ばんがーど	シェル・ヴァンガード	名詞	
しぇるばんがーど	シェル・ヴァンガード	名詞	
ふらったーず・でぃむ	フラッターズ・ディム	名詞	
ふらったーずでぃむ	フラッターズ・ディム	名詞	
とじんしょう	兎迅衝	名詞	
しょうそうげき	昇掃撃	名詞	
たいりんげっか	大輪月華	名詞	
だいりんげっか	大輪月華	名詞	タイリンゲッカ
しゅんじんそう	瞬迅爪	名詞	TOX レイアが使用
かっしんこん	活伸棍	名詞	
かっしんこん・わるつ	活伸棍・円舞	名詞	
かっしんこんわるつ	活伸棍・円舞	名詞	
かっしんこん・えんぶ	活伸棍・円舞	名詞	カッシンコンワルツ
かっしんこんえんぶ	活伸棍・円舞	名詞	カッシンコンワルツ
かっしんこん・かぐら	活伸棍・神楽	名詞	
かっしんこんかぐら	活伸棍・神楽	名詞	
てぃぽせんこう	ティポ戦吼	名詞	
せう゛ぇーどふぇいと	セヴェードフェイト	名詞	TOX ローエンが使用
せゔぇーどふぇいと	セヴェードフェイト	名詞	TOX ローエンが使用
せう゛ぇーとふぇいと	セヴェードフェイト	名詞	TOX ローエンが使用
せゔぇーとふぇいと	セヴェードフェイト	名詞	TOX ローエンが使用
せう゛ぇーどふぇいと	セヴァードフェイト	名詞	TOA ティアが使用
せゔぇーどふぇいと	セヴァードフェイト	名詞	TOA ティアが使用
あぶそりゅーと・こあ	アブソリュート・コア	名詞	
あぶそりゅーとこあ	アブソリュート・コア	名詞	
げんぶさん	玄武散	名詞	
そうさいじん	双砕迅	名詞	
えんせんじん	炎穿陣	名詞	
めっそうらんが	滅爪乱牙	名詞	
きじんれんせんしゅう	気刃連旋襲	名詞	
すぱいりっと・めでぃく	スパイリット・メディク	名詞	
すぱいりっとめでぃく	スパイリット・メディク	名詞	
むざんか	六散華	名詞	
かんくうきょうぶ	巻空鏡舞	名詞	
せんぱほうよくだん	閃破封翼弾	名詞	
ふうぶかっしんげき	封舞活震劇	名詞	ホウブカッシンゲキ
ふうぶかつしんげき	封舞活震劇	名詞	ホウブカッシンゲキ
ほうぶかっしんげき	封舞活震劇	名詞	
ほうぶかつしんげき	封舞活震劇	名詞	
すいげつれっぱ	水月烈破	名詞	
すいげつれつは	水月烈破	名詞	
しゅんじんふうが	瞬迅風牙	名詞	
ばくじんさんが	爆陣散画	名詞	
じれんだいばくしょう	時練大爆鐘	名詞	
ごうはてんぶよう	轟覇転武踊	名詞	
りゅうぶほうばっぱ	流舞崩爆破	名詞	TOX 共鳴術技
りゅうぶほうばくは	流舞崩爆破	名詞	TOX 共鳴術技
きょこうしょうは	拒甲掌破	名詞	
てんりゅうついじんせん	転留追刃穿	名詞	
ひてんしょうせいく	飛天翔星駆	名詞	
てぃぽ・ざ・びーすと	ティポ・ザ・ビースト	名詞	
てぃぽざびーすと	ティポ・ザ・ビースト	名詞	
てぃぽ・ばすたー	ティポ・BUSTER	名詞	
てぃぽばすたー	ティポ・BUSTER	名詞	
てぃぽ・ぶSてR	ティポ・BUSTER	名詞	
てぃぽぶSてR	ティポ・BUSTER	名詞	
う゛ぁいと・るいんふぉーす	ヴァイト・ルインフォース	名詞	
ゔぁいと・るいんふぉーす	ヴァイト・ルインフォース	名詞	
ばいと・るいんふぉーす	ヴァイト・ルインフォース	名詞	
う゛ぁいとるいんふぉーす	ヴァイト・ルインフォース	名詞	
ゔぁいとるいんふぉーす	ヴァイト・ルインフォース	名詞	
ばいとるいんふぉーす	ヴァイト・ルインフォース	名詞	
えれめんとふぉー	エレメント4	名詞	
えれめんとよん	エレメント4	名詞	
えれめんと4	エレメント4	名詞	
こがはざん・あぎと	虎牙破斬・咢	名詞	
こがはざんあぎと	虎牙破斬・咢	名詞	
げんえいりゅうじん	幻影流刃	名詞	
そうがこうれつじん	双牙煌裂陣	名詞	
あんりゅうそう	闇竜槍	名詞	
もうはそう	猛破槍	名詞	
しえんばくしょう	紫焔爆鐘	名詞	
ほうがんそう	崩岩槍	名詞	
しゅんさつごうばくしょう	瞬殺轟爆鐘	名詞	
ひょうか	氷禍	名詞	
ひょうそうげき	氷槍撃	名詞	
ひょうてんそう	氷転爪	名詞	
さいかひょうろう	彩華氷牢	名詞	
とうじんせんばくりゅう	凍刃穿爆隆	名詞	
とうじんとうさい	凍刃踏砕	名詞	
ろぎず・あくせる	ロギズ・アクセル	名詞	
ろぎずあくせる	ロギズ・アクセル	名詞	
ろぎず・いーたー	ロギズ・イーター	名詞	
ろぎずいーたー	ロギズ・イーター	名詞	
こんごうけん	金剛拳	名詞	
こがさいは	虎牙砕破	名詞	
ごうまりゅうしょうだん	轟魔隆衝断	名詞	
どらごねす・はんど	ドラゴネス・ハンド	名詞	
どらごねすはんど	ドラゴネス・ハンド	名詞	
どらごねす・へっど	ドラゴネス・ヘッド	名詞	
どらごねすへっど	ドラゴネス・ヘッド	名詞	
どらごねす・すにーかー	ドラゴネス・スニーカー	名詞	
どらごねすすにーかー	ドラゴネス・スニーカー	名詞	
びゃくがついれん	白牙追蓮	名詞	
はくがついれん	白牙追蓮	名詞	ビャクガツイレン
らいとにんぐのう゛ぁ	ライトニングノヴァ	名詞	
らいとにんぐのゔぁ	ライトニングノヴァ	名詞	
もうしょうらい	猛招来	名詞	
こうこうはざん	皇光破斬	名詞	
こうじんれっぱ	煌塵裂破	名詞	
こうじんれつは	煌塵裂破	名詞	
だんがしょうてん	断臥昇天	名詞	
だんかしょうわい	断禍消穢	名詞	
ひえんしゅんおうが	飛燕瞬王牙	名詞	
せいかめっさいじん	聖戈滅砕陣	名詞	
せいかめつさいじん	聖戈滅砕陣	名詞	
はおうてんしょうけん	覇王天衝剣	名詞	
びゃく・まじんおうけん	闢・魔神王剣	名詞	
びゃくまじんおうけん	闢・魔神王剣	名詞	
あう゛ぉいだんす	アヴォイダンス	名詞	
あゔぉいだんす	アヴォイダンス	名詞	
あぼいだんす	アヴォイダンス	名詞	
きずなくだくそうしゅ	絆砕く双手	名詞	
きゅうきのこうが	吸気の噛牙	名詞	
さくめいのせきそう	削命の石爪	名詞	
ちいさきやくせき	小さき厄石	名詞	
しついのといき	失意の吐息	名詞	
てんじゅのずがい	纏呪の頭蓋	名詞	
ぼうどくのせんそう	冒毒の戦爪	名詞	
もうでんのずがい	猛電の頭蓋	名詞	
さんだーすたう゛	サンダースタヴ	名詞	
さんだーすたゔ	サンダースタヴ	名詞	
さんだーすたぶ	サンダースタヴ	名詞	
むそうじんれつせん	夢想神烈閃	名詞	ツインブレイヴ クロエが使用
いちじん	一迅	名詞	
いちじんれっそう	一迅裂双	名詞	
いちじんれつそう	一迅裂双	名詞	
ごうがしょう	轟臥衝	名詞	
きょうげつせん	鏡月閃	名詞	
きょうげっせん	鏡月閃	名詞	
なきしぐれ	鳴時雨	名詞	
じゅうれっぱ	重裂破	名詞	
じゅうれつは	重裂破	名詞	
らいぷうじん	雷封刃	名詞	
らいふうじん	雷封刃	名詞	ライプウジン
ぬればがり	濡羽狩	名詞	
ぬれはがり	濡羽狩	名詞	ヌレバガリ
ぐれんしょうぶ	紅蓮翔舞	名詞	
まいはだれ	舞斑雪	名詞	
まいはだら	舞斑雪	名詞	マイハダレ
はだれがえし	斑雪返	名詞	
はだらがえし	斑雪返	名詞	ハダレガエシ
しえん	刺宴	名詞	
おぼろいたち	朧鼬	名詞	
そうじんらんぶ	双刃乱舞	名詞	
そうじんらんぶ	双針乱舞	名詞	
いんゔぁいたぶる	インヴァイタブル	名詞	
いんう゛ぁいたぶる	インヴァイタブル	名詞	
いんばいたぶる	インヴァイタブル	名詞	
そーと・らるで	ソート・ラルデ	名詞	
そーとらるで	ソート・ラルデ	名詞	
あう゛ぁんと・ぽすて	アヴァント・ポステ	名詞	
あう゛ぁんとぽすて	アヴァント・ポステ	名詞	
あばんと・ぽすて	アヴァント・ポステ	名詞	
あばんとぽすて	アヴァント・ポステ	名詞	
あゔぁんと・ぽすて	アヴァント・ポステ	名詞	
あゔぁんとぽすて	アヴァント・ポステ	名詞	
あう゛ぁんと・なーう゛	アヴァント・ナーヴ	名詞	
あう゛ぁんとなーう゛	アヴァント・ナーヴ	名詞	
あばんと・なーぶ	アヴァント・ナーヴ	名詞	
あばんとなーぶ	アヴァント・ナーヴ	名詞	
あばんと・なーう゛	アヴァント・ナーヴ	名詞	
あばんとなーう゛	アヴァント・ナーヴ	名詞	
あゔぁんと・なーゔ	アヴァント・ナーヴ	名詞	
あゔぁんとなーゔ	アヴァント・ナーヴ	名詞	
ふぁんが・ぷれせ	ファンガ・プレセ	名詞	
ふぁんがぷれせ	ファンガ・プレセ	名詞	
ありえる・がーで	アリエル・ガーデ	名詞	
さきおん・あくせ	サキオン・アクセ	名詞	
さきおんあくせ	サキオン・アクセ	名詞	
あんすたぶる・まいん	アンスタブル・マイン	名詞	
あんすたぶるまいん	アンスタブル・マイン	名詞	
ぶろい・てーれ	ブロイ・テーレ	名詞	
ぶろいてーれ	ブロイ・テーレ	名詞	
まぎか・ぶれーで	マギカ・ブレーデ	名詞	
まぎかぶれーで	マギカ・ブレーデ	名詞	
ふぁんどる・ぐらんで	ファンドル・グランデ	名詞	
ふぁんどるぐらんで	ファンドル・グランデ	名詞	
う゛ぉるてっくちぇいさー	ヴォルテックチェイサー	名詞	
ぼるてっくちぇいさー	ヴォルテックチェイサー	名詞	
ゔぉるてっくちぇいさー	ヴォルテックチェイサー	名詞	
らぴっど・ふるばーすと	ラピッド・フルバースト	名詞	
らぴっどふるばーすと	ラピッド・フルバースト	名詞	
ばっさいざん・あやみ	祓砕斬・零水	名詞	
ばっさいざんあやみ	祓砕斬・零水	名詞	
ばっさいざん	祓砕斬	名詞	
ばっさいざん	祓砕斬・零水	名詞	
またー・ですとらくと	マター・デストラクト	名詞	
またーですとらくと	マター・デストラクト	名詞	
けいが・そうじんらんぶ	継牙・双針乱舞	名詞	
けいがそうじんらんぶ	継牙・双針乱舞	名詞	
ゆうなぎ	夕凪	名詞	
くさなぎ	日柳	名詞	
ひやなぎ	日柳	名詞	クサナギ
ほうりゅうぶそうきゃく	崩竜武双脚	名詞	
まじぇすとほうぃーる	マジェストホウィール	名詞	
まじぇすとほいーる	マジェストホウィール	名詞	
まじぇすとほぃーる	マジェストホウィール	名詞	
ぷりずんせいゔぁー	プリズンセイヴァー	名詞	
ぷりずんせいう゛ぁー	プリズンセイヴァー	名詞	
ぷりずんせいばー	プリズンセイヴァー	名詞	
まじゅうしょう	魔銃衝	名詞	
まざんしょう	魔斬衝	名詞	
がりゅうらせんけん	我流螺旋剣	名詞	
ほうが	咆牙	名詞	
えんせんだ	円閃打	名詞	
そうりゅうこん	双流棍	名詞	
しゅんせんだ	隼穿打	名詞	
しゅうきほう	集気砲	名詞	TOX2 レイアが使用
しゅんじんそうは	瞬迅走破	名詞	
さーぺーんつう゛ぁいと	サーペンツヴァイト	名詞	
さーぺーんつばいと	サーペンツヴァイト	名詞	
さーぺーんつゔぁいと	サーペンツヴァイト	名詞	
みりおんう゛ぁいと	ミリオンヴァイト	名詞	
みりおんばいと	ミリオンヴァイト	名詞	
みろんゔぁいと	ミリオンヴァイト	名詞	
しゅうきじん	集気陣	名詞	
かいきこう	回帰功	名詞	TOX2 ガイアスが使用
すいりゅう	吹柳	名詞	
てんしんきゃく	転身脚	名詞	
びゃっきじん	白鬼塵	名詞	
びゃくきじん	白鬼塵	名詞	ビャッキジン
はくきじん	白鬼塵	名詞	ビャッキジン
はっきじん	白鬼塵	名詞	ビャッキジン
まじんしゅんれんざん	魔神瞬連斬	名詞	
しりゅうせんこうざん	刺龍穿光斬	名詞	
そうはれんざん	双覇連散	名詞	
そうはれんさん	双覇連散	名詞	ソウハレンザン
しじんほうこう	獅儘封吼	名詞	
しじんふうこう	獅儘封吼	名詞	シジンホウコウ
がりょうれっか	臥龍裂渦	名詞	
がりょうれつか	臥龍裂渦	名詞	
がりゅうれっか	臥龍裂渦	名詞	ガリョウレッカ
がりゅうれつか	臥龍裂渦	名詞	ガリョウレッカ
りゅうせいつい	流星槌	名詞	
むだんが	六断牙	名詞	
ろくだんが	六断牙	名詞	ムダンガ
りくだんが	六断牙	名詞	ムダン
やいとすざく	灸朱雀	名詞	
へう゛ゔんずれぽーと	ヘヴンズレポート	名詞	
へう゛んずれぽーと	ヘヴンズレポート	名詞	
へぶんずれぽーと	ヘヴンズレポート	名詞	
そうきゅうてんく	蒼穹天駆	名詞	
はじゃしちしせい	破邪七支星	名詞	
はじゃひちしせい	破邪七支星	名詞	ハジャシチシセイ
はじゃななしせい	破邪七支星	名詞	ハジャシチシセイ
はじゃなしせい	破邪七支星	名詞	ハジャシチシセイ
てんこくまじんしょう	十刻魔神衝	名詞	
じゅうこくまじんしょう	十刻魔神衝	名詞	テンコクマジンショウ
じゅっこくまじんしょう	十刻魔神衝	名詞	テンコクマジンショウ
しじんれんせんこう	獅神連戦吼	名詞	
ぐらう゛ぃてぃふぁんぐ	グラヴィティファング	名詞	
ぐらゔぃてぃふぁんぐ	グラヴィティファング	名詞	
ぐらびてぃふぁんぐ	グラヴィティファング	名詞	
てんせんじん	天穿陣	名詞	
そうりゅうれっこうざん	双竜裂咬斬	名詞	
そうりゅうれつこうざん	双竜裂咬斬	名詞	
しゅんじんほうだ	瞬迅崩打	名詞	
ようじんげっか	陽塵月華	名詞	
ようじんげつか	陽塵月華	名詞	
せんぱほうよくざん	閃破封翼斬	名詞	
せんはほうよくざん	閃破封翼斬	名詞	
せんぱふうよくざん	閃破封翼斬	名詞	センパフウヨクザン
せんはふうよくざん	閃破封翼斬	名詞	センパフウヨクザン
しゅんじんこうが	瞬迅光牙	名詞	
ぐらう゛ぃてぃぼむ	グラヴィティボム	名詞	
ぐらゔぃてぃぼむ	グラヴィティボム	名詞	
ぐらびてぃぼむ	グラヴィティボム	名詞	
てんしょうふうばくさつ	天招風縛刹	名詞	
じゅうが・ふうばくさつ	十臥・風縛刹	名詞	
じゅうがふうばくさつ	十臥・風縛刹	名詞	
ばれっと・くるしふぃくしょん	バレット・クルシフィクション	名詞	
ばれっとくるしふぃくしょん	バレット・クルシフィクション	名詞	
れつ・しんのうあっさいげき	烈・震皇圧砕撃	名詞	
れつしんのうあっさいげき	烈・震皇圧砕撃	名詞	
れつ・しんのうあつさいげき	烈・震皇圧砕撃	名詞	
れつしんのうあつさいげき	烈・震皇圧砕撃	名詞	
れつ・しんおうあっさいげき	烈・震皇圧砕撃	名詞	レツ・シンノウアッサイゲキ
れつしんおうあっさいげき	烈・震皇圧砕撃	名詞	レツ・シンノウアッサイゲキ
れつ・しんおうあつさいげき	烈・震皇圧砕撃	名詞	レツ・シンノウアッサイゲキ
れつしんおうあつさいげき	烈・震皇圧砕撃	名詞	レツ・シンノウアッサイゲキ
べんう゛ぇぬーと・えんふぇるね	ベンヴェヌート・エンフェルネ	名詞	
べんゔぇぬーと・えんふぇるね	ベンヴェヌート・エンフェルネ	名詞	
べんべぬーと・えんふぇるね	ベンヴェヌート・エンフェルネ	名詞	
べんう゛ぇぬーとえんふぇるね	ベンヴェヌート・エンフェルネ	名詞	
べんゔぇぬーとえんふぇるね	ベンヴェヌート・エンフェルネ	名詞	
べんべぬーとえんふぇるね	ベンヴェヌート・エンフェルネ	名詞	
ぴんく・ぴんかー・ぴんきすと	ピンク・ピンカー・ピンキスト	名詞	
ぴんくぴんかーぴんきすと	ピンク・ピンカー・ピンキスト	名詞	
てぃーろ・すふぉるつぁんど	ティーロ・スフォルツァンド	名詞	
てぃーろすふぉるつぁんど	ティーロ・スフォルツァンド	名詞	
せんけんざんう・がおうせんれつこう	閃剣斬雨・駕王閃裂交	名詞	
せんけんざんうがおうせんれつこう	閃剣斬雨・駕王閃裂交	名詞	
せんけんざんう	閃剣斬雨	名詞	
せんけんざんう	閃剣斬雨・駕王閃裂交	名詞	
がおうせんれつこう	駕王閃裂交	名詞	
せんけんざんう・がおうせんれっこう	閃剣斬雨・駕王閃裂交	名詞	
せんけんざんうがおうせんれっこう	閃剣斬雨・駕王閃裂交	名詞	
がおうせんれっこう	駕王閃裂交	名詞	
わいるど・こんびねーしょん	我威留努・魂微音維紫苑	名詞	
わいるどこんびねーしょん	我威留努・魂微音維紫苑	名詞	
くるーある・ぐらう゛ぃてぃ	クルーアル・グラヴィティ	名詞	
くるーある・ぐらゔぃてぃ	クルーアル・グラヴィティ	名詞	
くるーある・ぐらびてぃ	クルーアル・グラヴィティ	名詞	
くるーあるぐらう゛ぃてぃ	クルーアル・グラヴィティ	名詞	
くるーあるぐらゔぃてぃ	クルーアル・グラヴィティ	名詞	
くるーあるぐらびてぃ	クルーアル・グラヴィティ	名詞	
せんりゅうか	旋龍火	名詞	
きこうばくじん	輝降縛陣	名詞	
くりむぞん・だすく	CRIMSON・DUSK	名詞	
くりむぞんだすく	CRIMSON・DUSK	名詞	
あんすてぃぐ・すとーむ	アンスティグ・ストーム	名詞	
あんすてぃぐすとーむ	アンスティグ・ストーム	名詞	
だんしんぐ・べおねっと	ダンシング・ベオネット	名詞	
だんしんぐべおねっと	ダンシング・ベオネット	名詞	
とれな・ぱそーじゅ	トレナ・パソージェ	名詞	
とれなぱそーじゅ	トレナ・パソージェ	名詞	
ばいえる・べおねっと	バイエル・ベオネット	名詞	
ばいえるべおねっと	バイエル・ベオネット	名詞	
ねいじぇる・すくろっと	ネイジェル・スクロット	名詞	
ねいじぇるすくろっと	ネイジェル・スクロット	名詞	
すぱるちな・りーれ	スパルチナ・リーレ	名詞	
すぱいん・びゅーと	スパイン・ビュート	名詞	
すぱいんびゅーと	スパイン・ビュート	名詞	
そうじんれんげ	双陣蓮華	名詞	
ばっさいざん・じゅうが	祓砕斬・十臥	名詞	
ばっさいざんじゅうが	祓砕斬・十臥	名詞	
ばっさいざん	祓砕斬・十臥	名詞	
たおむ・えせんてぃあ	タイム・エセンティア	名詞	
たおむえせんてぃあ	タイム・エセンティア	名詞	
たいむ・くれーめる	タイム・クレーメル	名詞	
たいむくれーめる	タイム・クレーメル	名詞	
まじんけん・ばくが	魔神拳・爆牙	名詞	
まじんけんばくが	魔神拳・爆牙	名詞	
ばくせん	幕穿	名詞	
れっすいけん	烈醒拳	名詞	
どごうさい	怒号犀	名詞	
さいほう	犀咆	名詞	
ぎしょうちょう	戯笑蝶	名詞	
ようろうちょう	踊弄蝶	名詞	
ほうらくちょう	抱絡蝶	名詞	
ちょうぶほうおう	蝶舞蜂殴	名詞	
ごうれつばくさい	豪烈暴犀	名詞	
こうぶおうようちょう	叩舞殴揺蝶	名詞	
ぜっけん	絶拳	名詞	
ぜつけん	絶拳	名詞	
えくす・すれい	エクス・スレイ	名詞	
えくすすれい	エクス・スレイ	名詞	
さかだつとうしん	逆立つ闘針	名詞	
せきかのだとつ	石化の打突	名詞	
そくばくのこうきゅうじん	束縛の光球陣	名詞	
ろーる・ろーる	ロール・ロール	名詞	
ろーるろーる	ロール・ロール	名詞	
ふりーだむ・わけみ	フリーダム・ワケミ	名詞	
ふりーだむわけみ	フリーダム・ワケミ	名詞	
れんぞくそくてん	連続そくてん	名詞	
しゅしゅっとなげます	斬裂の鎌鼬	名詞	
ざんれつのかまいたち	斬裂の鎌鼬	名詞	シュシュットナゲマス
だれかとめて	肉弾火旋輪	名詞	
にくだんかせんりん	肉弾火旋輪	名詞	ダレカトメテ…
ひーからい	炎獄の吐息	名詞	
えんごくのといき	炎獄の吐息	名詞	ヒー！カライ！！
はれときどきいわ	厄災の巨石	名詞	ハレトキドキイワ
やくさいのきょせき	厄災の巨石	名詞	ハレトキドキイワ
じごくりふてぃんぐ	地獄リフティング	名詞	
だいう゛すいすいー	ダイヴ！スイスイ〜♪	名詞	
だいゔすいすいー	ダイヴ！スイスイ〜♪	名詞	
だいぶすいすいー	ダイヴ！スイスイ〜♪	名詞	
だいう゛すいすい	ダイヴ！スイスイ〜♪	名詞	
だいゔすいすい	ダイヴ！スイスイ〜♪	名詞	
だいぶすいすい	ダイヴ！スイスイ〜♪	名詞	
しん・だいう゛すいすいー	真・ダイヴ！スイスイ〜♪	名詞	
しん・だいゔすいすいー	真・ダイヴ！スイスイ〜♪	名詞	
しん・だいぶすいすいー	真・ダイヴ！スイスイ〜♪	名詞	
しん・だいう゛すいすい	真・ダイヴ！スイスイ〜♪	名詞	
しん・だいゔすいすい	真・ダイヴ！スイスイ〜♪	名詞	
しん・だいぶすいすい	真・ダイヴ！スイスイ〜♪	名詞	
しんだいう゛すいすいー	真・ダイヴ！スイスイ〜♪	名詞	
しんだいゔすいすいー	真・ダイヴ！スイスイ〜♪	名詞	
しんだいぶすいすいー	真・ダイヴ！スイスイ〜♪	名詞	
しんだいう゛すいすい	真・ダイヴ！スイスイ〜♪	名詞	
しんだいゔすいすい	真・ダイヴ！スイスイ〜♪	名詞	
しんだいぶすいすい	真・ダイヴ！スイスイ〜♪	名詞	
じぇっとぱんち	じぇっと★ぱんち	名詞	
せんのうびーむ	せんのう★びーむ	名詞	
じょうかのびゃくが	浄化の白牙	名詞	
ぜつぼうのきゅうけつ	絶望の吸穴	名詞	
らすと・いーたー	ラスト・イーター	名詞	
らすといーたー	ラスト・イーター	名詞	
すごく・じゃれる	スゴク・ジャレル	名詞	
